area,areaid,dailydose1,dailydose2,daydiff,daytotal,referencedate,totaldistinctpersons,totaldose1,totaldose2,totalvaccinations
ΑΙΤΩΛΟΑΚΑΡΝΑΝΙΑΣ,701,124,67,-5,191,2021-01-28T00:00:00,1904,1904,212,2116
ΑΝΑΤΟΛΙΚΗΣ ΑΤΤΙΚΗΣ,901,394,76,4,470,2021-01-28T00:00:00,3789,3789,607,4396
ΑΝΔΡΟΥ,1201,55,0,55,55,2021-01-28T00:00:00,55,55,0,55
ΑΡΓΟΛΙΔΑΣ,1001,128,1,-19,129,2021-01-28T00:00:00,1697,1697,1,1698
ΑΡΚΑΔΙΑΣ,1002,92,69,29,161,2021-01-28T00:00:00,1712,1712,69,1781
ΑΡΤΑΣ,401,77,49,-12,126,2021-01-28T00:00:00,1720,1720,192,1912
ΑΧΑΪΑΣ,702,323,254,43,577,2021-01-28T00:00:00,5663,5663,1353,7016
ΒΟΙΩΤΙΑΣ,801,158,4,7,162,2021-01-28T00:00:00,1646,1646,4,1650
ΒΟΡΕΙΟΥ ΤΟΜΕΑ ΑΘΗΝΩΝ,902,838,789,43,1627,2021-01-28T00:00:00,28548,28548,2428,30976
ΓΡΕΒΕΝΩΝ,301,50,0,2,50,2021-01-28T00:00:00,667,667,0,667
ΔΡΑΜΑΣ,101,150,0,0,150,2021-01-28T00:00:00,1771,1771,0,1771
ΔΥΤΙΚΗΣ ΑΤΤΙΚΗΣ,903,125,55,6,180,2021-01-28T00:00:00,1883,1883,389,2272
ΔΥΤΙΚΟΥ ΤΟΜΕΑ ΑΘΗΝΩΝ,904,578,156,-4,734,2021-01-28T00:00:00,8105,8105,800,8905
ΕΒΡΟΥ,102,227,1,-17,228,2021-01-28T00:00:00,3551,3551,1,3552
ΕΥΒΟΙΑΣ,802,275,49,-66,324,2021-01-28T00:00:00,3492,3492,49,3541
ΕΥΡΥΤΑΝΙΑΣ,803,36,0,6,36,2021-01-28T00:00:00,445,445,0,445
ΖΑΚΥΝΘΟΥ,601,48,0,-13,48,2021-01-28T00:00:00,873,873,0,873
ΗΛΕΙΑΣ,703,141,48,-14,189,2021-01-28T00:00:00,2207,2207,48,2255
ΗΜΑΘΙΑΣ,201,164,46,12,210,2021-01-28T00:00:00,2126,2126,188,2314
ΗΡΑΚΛΕΙΟΥ,1301,335,118,-19,453,2021-01-28T00:00:00,6638,6638,489,7127
ΘΑΣΟΥ,103,41,0,41,41,2021-01-28T00:00:00,41,41,0,41
ΘΕΣΠΡΩΤΙΑΣ,402,50,40,-12,90,2021-01-28T00:00:00,1214,1214,40,1254
ΘΕΣΣΑΛΟΝΙΚΗΣ,202,1040,945,-82,1985,2021-01-28T00:00:00,23303,23303,3759,27062
ΘΗΡΑΣ,1202,24,0,6,24,2021-01-28T00:00:00,209,209,0,209
ΙΘΑΚΗΣ,602,0,0,0,0,2021-01-28T00:00:00,0,0,0,0
ΙΚΑΡΙΑΣ,1101,24,0,12,24,2021-01-28T00:00:00,225,225,0,225
ΙΩΑΝΝΙΝΩΝ,403,197,217,-17,414,2021-01-28T00:00:00,5062,5062,1112,6174
ΚΑΒΑΛΑΣ,104,210,0,5,210,2021-01-28T00:00:00,2377,2377,2,2379
ΚΑΛΥΜΝΟΥ,1203,61,0,1,61,2021-01-28T00:00:00,500,500,0,500
ΚΑΡΔΙΤΣΑΣ,501,114,99,-9,213,2021-01-28T00:00:00,2124,2124,381,2505
ΚΑΡΠΑΘΟΥ,1204,18,0,18,18,2021-01-28T00:00:00,165,165,0,165
ΚΑΣΤΟΡΙΑΣ,302,90,0,-6,90,2021-01-28T00:00:00,1095,1095,0,1095
ΚΕΑΣ-ΚΥΘΝΟΥ,1205,0,0,0,0,2021-01-28T00:00:00,0,0,0,0
ΚΕΝΤΡΙΚΟΥ ΤΟΜΕΑ ΑΘΗΝΩΝ,905,1413,1809,-55,3222,2021-01-28T00:00:00,32950,32950,7645,40595
ΚΕΡΚΥΡΑΣ,603,84,0,-48,84,2021-01-28T00:00:00,1982,1982,0,1982
ΚΕΦΑΛΛΗΝΙΑΣ,604,134,0,44,134,2021-01-28T00:00:00,1146,1146,0,1146
ΚΙΛΚΙΣ,203,126,0,-12,126,2021-01-28T00:00:00,1632,1632,0,1632
ΚΟΖΑΝΗΣ,303,141,81,18,222,2021-01-28T00:00:00,1982,1982,394,2376
ΚΟΡΙΝΘΙΑΣ,1003,127,23,0,150,2021-01-28T00:00:00,1305,1305,165,1470
ΚΩ,1206,78,0,36,78,2021-01-28T00:00:00,593,593,1,594
ΛΑΚΩΝΙΑΣ,1004,45,105,19,150,2021-01-28T00:00:00,1747,1747,107,1854
ΛΑΡΙΣΑΣ,502,195,189,34,384,2021-01-28T00:00:00,4126,4126,1210,5336
ΛΑΣΙΘΙΟΥ,1302,239,1,-18,240,2021-01-28T00:00:00,2616,2616,1,2617
ΛΕΣΒΟΥ,1102,114,0,-18,114,2021-01-28T00:00:00,1591,1591,0,1591
ΛΕΥΚΑΔΑΣ,605,66,0,30,66,2021-01-28T00:00:00,639,639,0,639
ΛΗΜΝΟΥ,1103,23,0,-13,23,2021-01-28T00:00:00,490,490,0,490
ΜΑΓΝΗΣΙΑΣ,503,220,1,-49,221,2021-01-28T00:00:00,2148,2148,1,2149
ΜΕΣΣΗΝΙΑΣ,1005,183,45,-12,228,2021-01-28T00:00:00,2673,2673,45,2718
ΜΗΛΟΥ,1207,12,0,12,12,2021-01-28T00:00:00,12,12,0,12
ΜΥΚΟΝΟΥ,1208,36,0,36,36,2021-01-28T00:00:00,36,36,0,36
ΝΑΞΟΥ,1209,18,0,-12,18,2021-01-28T00:00:00,276,276,0,276
ΝΗΣΩΝ,906,187,0,169,187,2021-01-28T00:00:00,335,335,0,335
ΝΟΤΙΟΥ ΤΟΜΕΑ ΑΘΗΝΩΝ,907,288,0,12,288,2021-01-28T00:00:00,3796,3796,0,3796
ΞΑΝΘΗΣ,105,116,10,30,126,2021-01-28T00:00:00,1534,1534,10,1544
ΠΑΡΟΥ,1210,42,0,42,42,2021-01-28T00:00:00,42,42,0,42
ΠΕΙΡΑΙΩΣ,908,539,118,-46,657,2021-01-28T00:00:00,8207,8207,391,8598
ΠΕΛΛΑΣ,204,133,105,-68,238,2021-01-28T00:00:00,2132,2132,380,2512
ΠΙΕΡΙΑΣ,205,166,19,0,185,2021-01-28T00:00:00,1574,1574,273,1847
ΠΡΕΒΕΖΑΣ,404,8,46,3,54,2021-01-28T00:00:00,842,842,46,888
ΡΕΘΥΜΝΟΥ,1303,137,0,-1,137,2021-01-28T00:00:00,1615,1615,0,1615
ΡΟΔΟΠΗΣ,106,96,0,0,96,2021-01-28T00:00:00,1167,1167,0,1167
ΡΟΔΟΥ,1211,144,0,-100,144,2021-01-28T00:00:00,1621,1621,0,1621
ΣΑΜΟΥ,1104,30,0,-12,30,2021-01-28T00:00:00,592,592,2,594
ΣΕΡΡΩΝ,206,168,0,18,168,2021-01-28T00:00:00,1927,1927,0,1927
ΣΠΟΡΑΔΩΝ,504,42,0,42,42,2021-01-28T00:00:00,42,42,0,42
ΣΥΡΟΥ,1212,30,0,-12,30,2021-01-28T00:00:00,562,562,0,562
ΤΗΝΟΥ,1213,46,0,46,46,2021-01-28T00:00:00,46,46,0,46
ΤΡΙΚΑΛΩΝ,505,110,95,8,205,2021-01-28T00:00:00,2316,2316,379,2695
ΦΘΙΩΤΙΔΑΣ,804,117,45,-30,162,2021-01-28T00:00:00,2314,2314,45,2359
ΦΛΩΡΙΝΑΣ,304,78,0,-18,78,2021-01-28T00:00:00,1036,1036,0,1036
ΦΩΚΙΔΑΣ,805,42,0,-12,42,2021-01-28T00:00:00,600,600,0,600
ΧΑΛΚΙΔΙΚΗΣ,207,107,1,-36,108,2021-01-28T00:00:00,1242,1242,3,1245
ΧΑΝΙΩΝ,1304,212,142,-62,354,2021-01-28T00:00:00,3464,3464,575,4039
ΧΙΟΥ,1105,48,0,0,48,2021-01-28T00:00:00,731,731,0,731
ΑΙΤΩΛΟΑΚΑΡΝΑΝΙΑΣ,701,82,98,-11,180,2021-01-29T00:00:00,1986,1986,310,2296
ΑΝΑΤΟΛΙΚΗΣ ΑΤΤΙΚΗΣ,901,454,6,-10,460,2021-01-29T00:00:00,4243,4243,613,4856
ΑΝΔΡΟΥ,1201,53,0,-2,53,2021-01-29T00:00:00,108,108,0,108
ΑΡΓΟΛΙΔΑΣ,1001,51,110,32,161,2021-01-29T00:00:00,1748,1748,111,1859
ΑΡΚΑΔΙΑΣ,1002,59,92,-10,151,2021-01-29T00:00:00,1771,1771,161,1932
ΑΡΤΑΣ,401,76,80,30,156,2021-01-29T00:00:00,1796,1796,272,2068
ΑΧΑΪΑΣ,702,285,169,-123,454,2021-01-29T00:00:00,5948,5948,1522,7470
ΒΟΙΩΤΙΑΣ,801,59,91,-12,150,2021-01-29T00:00:00,1705,1705,95,1800
ΒΟΡΕΙΟΥ ΤΟΜΕΑ ΑΘΗΝΩΝ,902,1222,944,539,2166,2021-01-29T00:00:00,29770,29770,3372,33142
ΓΡΕΒΕΝΩΝ,301,9,45,4,54,2021-01-29T00:00:00,676,676,45,721
ΔΡΑΜΑΣ,101,51,93,-6,144,2021-01-29T00:00:00,1822,1822,93,1915
ΔΥΤΙΚΗΣ ΑΤΤΙΚΗΣ,903,130,26,-24,156,2021-01-29T00:00:00,2013,2013,415,2428
ΔΥΤΙΚΟΥ ΤΟΜΕΑ ΑΘΗΝΩΝ,904,479,461,206,940,2021-01-29T00:00:00,8584,8584,1261,9845
ΕΒΡΟΥ,102,124,92,-12,216,2021-01-29T00:00:00,3675,3675,93,3768
ΕΥΒΟΙΑΣ,802,220,157,53,377,2021-01-29T00:00:00,3712,3712,206,3918
ΕΥΡΥΤΑΝΙΑΣ,803,1,47,12,48,2021-01-29T00:00:00,446,446,47,493
ΖΑΚΥΝΘΟΥ,601,66,0,18,66,2021-01-29T00:00:00,939,939,0,939
ΗΛΕΙΑΣ,703,86,145,42,231,2021-01-29T00:00:00,2293,2293,193,2486
ΗΜΑΘΙΑΣ,201,102,102,-6,204,2021-01-29T00:00:00,2228,2228,290,2518
ΗΡΑΚΛΕΙΟΥ,1301,205,215,-33,420,2021-01-29T00:00:00,6843,6843,704,7547
ΘΑΣΟΥ,103,49,0,8,49,2021-01-29T00:00:00,90,90,0,90
ΘΕΣΠΡΩΤΙΑΣ,402,15,81,6,96,2021-01-29T00:00:00,1229,1229,121,1350
ΘΕΣΣΑΛΟΝΙΚΗΣ,202,915,997,-73,1912,2021-01-29T00:00:00,24218,24218,4756,28974
ΘΗΡΑΣ,1202,12,0,-12,12,2021-01-29T00:00:00,221,221,0,221
ΙΘΑΚΗΣ,602,0,0,0,0,2021-01-29T00:00:00,0,0,0,0
ΙΚΑΡΙΑΣ,1101,11,1,-12,12,2021-01-29T00:00:00,236,236,1,237
ΙΩΑΝΝΙΝΩΝ,403,187,151,-76,338,2021-01-29T00:00:00,5249,5249,1263,6512
ΚΑΒΑΛΑΣ,104,93,93,-24,186,2021-01-29T00:00:00,2470,2470,95,2565
ΚΑΛΥΜΝΟΥ,1203,22,1,-38,23,2021-01-29T00:00:00,522,522,1,523
ΚΑΡΔΙΤΣΑΣ,501,105,139,31,244,2021-01-29T00:00:00,2229,2229,520,2749
ΚΑΡΠΑΘΟΥ,1204,18,0,0,18,2021-01-29T00:00:00,183,183,0,183
ΚΑΣΤΟΡΙΑΣ,302,69,47,26,116,2021-01-29T00:00:00,1164,1164,47,1211
ΚΕΑΣ-ΚΥΘΝΟΥ,1205,0,0,0,0,2021-01-29T00:00:00,0,0,0,0
ΚΕΝΤΡΙΚΟΥ ΤΟΜΕΑ ΑΘΗΝΩΝ,905,1347,2186,311,3533,2021-01-29T00:00:00,34297,34297,9831,44128
ΚΕΡΚΥΡΑΣ,603,84,0,0,84,2021-01-29T00:00:00,2066,2066,0,2066
ΚΕΦΑΛΛΗΝΙΑΣ,604,97,0,-37,97,2021-01-29T00:00:00,1243,1243,0,1243
ΚΙΛΚΙΣ,203,19,95,-12,114,2021-01-29T00:00:00,1651,1651,95,1746
ΚΟΖΑΝΗΣ,303,148,50,-24,198,2021-01-29T00:00:00,2130,2130,444,2574
ΚΟΡΙΝΘΙΑΣ,1003,91,53,-6,144,2021-01-29T00:00:00,1396,1396,218,1614
ΚΩ,1206,36,0,-42,36,2021-01-29T00:00:00,629,629,1,630
ΛΑΚΩΝΙΑΣ,1004,14,125,-11,139,2021-01-29T00:00:00,1761,1761,232,1993
ΛΑΡΙΣΑΣ,502,128,196,-60,324,2021-01-29T00:00:00,4254,4254,1406,5660
ΛΑΣΙΘΙΟΥ,1302,123,150,33,273,2021-01-29T00:00:00,2739,2739,151,2890
ΛΕΣΒΟΥ,1102,120,0,6,120,2021-01-29T00:00:00,1711,1711,0,1711
ΛΕΥΚΑΔΑΣ,605,48,0,-18,48,2021-01-29T00:00:00,687,687,0,687
ΛΗΜΝΟΥ,1103,30,0,7,30,2021-01-29T00:00:00,520,520,0,520
ΜΑΓΝΗΣΙΑΣ,503,166,44,-11,210,2021-01-29T00:00:00,2314,2314,45,2359
ΜΕΣΣΗΝΙΑΣ,1005,125,145,42,270,2021-01-29T00:00:00,2798,2798,190,2988
ΜΗΛΟΥ,1207,6,0,-6,6,2021-01-29T00:00:00,18,18,0,18
ΜΥΚΟΝΟΥ,1208,18,0,-18,18,2021-01-29T00:00:00,54,54,0,54
ΝΑΞΟΥ,1209,12,0,-6,12,2021-01-29T00:00:00,288,288,0,288
ΝΗΣΩΝ,906,157,0,-30,157,2021-01-29T00:00:00,492,492,0,492
ΝΟΤΙΟΥ ΤΟΜΕΑ ΑΘΗΝΩΝ,907,293,1,6,294,2021-01-29T00:00:00,4089,4089,1,4090
ΞΑΝΘΗΣ,105,55,65,-6,120,2021-01-29T00:00:00,1589,1589,75,1664
ΠΑΡΟΥ,1210,30,0,-12,30,2021-01-29T00:00:00,72,72,0,72
ΠΕΙΡΑΙΩΣ,908,320,444,107,764,2021-01-29T00:00:00,8527,8527,835,9362
ΠΕΛΛΑΣ,204,159,87,8,246,2021-01-29T00:00:00,2291,2291,467,2758
ΠΙΕΡΙΑΣ,205,146,28,-11,174,2021-01-29T00:00:00,1720,1720,301,2021
ΠΡΕΒΕΖΑΣ,404,5,73,24,78,2021-01-29T00:00:00,847,847,119,966
ΡΕΘΥΜΝΟΥ,1303,92,48,3,140,2021-01-29T00:00:00,1707,1707,48,1755
ΡΟΔΟΠΗΣ,106,48,48,0,96,2021-01-29T00:00:00,1215,1215,48,1263
ΡΟΔΟΥ,1211,137,0,-7,137,2021-01-29T00:00:00,1758,1758,0,1758
ΣΑΜΟΥ,1104,41,1,12,42,2021-01-29T00:00:00,633,633,3,636
ΣΕΡΡΩΝ,206,44,94,-30,138,2021-01-29T00:00:00,1971,1971,94,2065
ΣΠΟΡΑΔΩΝ,504,42,0,0,42,2021-01-29T00:00:00,84,84,0,84
ΣΥΡΟΥ,1212,36,0,6,36,2021-01-29T00:00:00,598,598,0,598
ΤΗΝΟΥ,1213,48,0,2,48,2021-01-29T00:00:00,94,94,0,94
ΤΡΙΚΑΛΩΝ,505,90,108,-7,198,2021-01-29T00:00:00,2406,2406,487,2893
ΦΘΙΩΤΙΔΑΣ,804,81,99,18,180,2021-01-29T00:00:00,2395,2395,144,2539
ΦΛΩΡΙΝΑΣ,304,40,50,12,90,2021-01-29T00:00:00,1076,1076,50,1126
ΦΩΚΙΔΑΣ,805,3,45,6,48,2021-01-29T00:00:00,603,603,45,648
ΧΑΛΚΙΔΙΚΗΣ,207,78,48,18,126,2021-01-29T00:00:00,1320,1320,51,1371
ΧΑΝΙΩΝ,1304,206,179,31,385,2021-01-29T00:00:00,3670,3670,754,4424
ΧΙΟΥ,1105,60,0,12,60,2021-01-29T00:00:00,791,791,0,791
ΑΙΤΩΛΟΑΚΑΡΝΑΝΙΑΣ,701,98,88,6,186,2021-01-30T00:00:00,2084,2084,398,2482
ΑΝΑΤΟΛΙΚΗΣ ΑΤΤΙΚΗΣ,901,440,3,-17,443,2021-01-30T00:00:00,4683,4683,616,5299
ΑΝΔΡΟΥ,1201,0,0,-53,0,2021-01-30T00:00:00,108,108,0,108
ΑΡΓΟΛΙΔΑΣ,1001,55,86,-20,141,2021-01-30T00:00:00,1803,1803,197,2000
ΑΡΚΑΔΙΑΣ,1002,62,141,52,203,2021-01-30T00:00:00,1833,1833,302,2135
ΑΡΤΑΣ,401,69,81,-6,150,2021-01-30T00:00:00,1865,1865,353,2218
ΑΧΑΪΑΣ,702,427,100,73,527,2021-01-30T00:00:00,6375,6375,1622,7997
ΒΟΙΩΤΙΑΣ,801,86,88,24,174,2021-01-30T00:00:00,1791,1791,183,1974
ΒΟΡΕΙΟΥ ΤΟΜΕΑ ΑΘΗΝΩΝ,902,948,118,-1100,1066,2021-01-30T00:00:00,30718,30718,3490,34208
ΓΡΕΒΕΝΩΝ,301,6,42,-6,48,2021-01-30T00:00:00,682,682,87,769
ΔΡΑΜΑΣ,101,49,95,0,144,2021-01-30T00:00:00,1871,1871,188,2059
ΔΥΤΙΚΗΣ ΑΤΤΙΚΗΣ,903,212,3,59,215,2021-01-30T00:00:00,2225,2225,418,2643
ΔΥΤΙΚΟΥ ΤΟΜΕΑ ΑΘΗΝΩΝ,904,501,435,-4,936,2021-01-30T00:00:00,9085,9085,1696,10781
ΕΒΡΟΥ,102,91,142,17,233,2021-01-30T00:00:00,3766,3766,235,4001
ΕΥΒΟΙΑΣ,802,289,95,7,384,2021-01-30T00:00:00,4001,4001,301,4302
ΕΥΡΥΤΑΝΙΑΣ,803,5,37,-6,42,2021-01-30T00:00:00,451,451,84,535
ΖΑΚΥΝΘΟΥ,601,66,0,0,66,2021-01-30T00:00:00,1005,1005,0,1005
ΗΛΕΙΑΣ,703,145,128,42,273,2021-01-30T00:00:00,2438,2438,321,2759
ΗΜΑΘΙΑΣ,201,86,100,-18,186,2021-01-30T00:00:00,2314,2314,390,2704
ΗΡΑΚΛΕΙΟΥ,1301,247,215,42,462,2021-01-30T00:00:00,7090,7090,919,8009
ΘΑΣΟΥ,103,42,0,-7,42,2021-01-30T00:00:00,132,132,0,132
ΘΕΣΠΡΩΤΙΑΣ,402,42,54,0,96,2021-01-30T00:00:00,1271,1271,175,1446
ΘΕΣΣΑΛΟΝΙΚΗΣ,202,1119,697,-96,1816,2021-01-30T00:00:00,25337,25337,5453,30790
ΘΗΡΑΣ,1202,24,0,12,24,2021-01-30T00:00:00,245,245,0,245
ΙΘΑΚΗΣ,602,0,0,0,0,2021-01-30T00:00:00,0,0,0,0
ΙΚΑΡΙΑΣ,1101,48,0,36,48,2021-01-30T00:00:00,284,284,1,285
ΙΩΑΝΝΙΝΩΝ,403,176,258,96,434,2021-01-30T00:00:00,5425,5425,1521,6946
ΚΑΒΑΛΑΣ,104,82,92,-12,174,2021-01-30T00:00:00,2552,2552,187,2739
ΚΑΛΥΜΝΟΥ,1203,54,0,31,54,2021-01-30T00:00:00,576,576,1,577
ΚΑΡΔΙΤΣΑΣ,501,214,14,-16,228,2021-01-30T00:00:00,2443,2443,534,2977
ΚΑΡΠΑΘΟΥ,1204,12,0,-6,12,2021-01-30T00:00:00,195,195,0,195
ΚΑΣΤΟΡΙΑΣ,302,48,48,-20,96,2021-01-30T00:00:00,1212,1212,95,1307
ΚΕΑΣ-ΚΥΘΝΟΥ,1205,0,0,0,0,2021-01-30T00:00:00,0,0,0,0
ΚΕΝΤΡΙΚΟΥ ΤΟΜΕΑ ΑΘΗΝΩΝ,905,1676,1113,-744,2789,2021-01-30T00:00:00,35973,35973,10944,46917
ΚΕΡΚΥΡΑΣ,603,96,0,12,96,2021-01-30T00:00:00,2162,2162,0,2162
ΚΕΦΑΛΛΗΝΙΑΣ,604,125,0,28,125,2021-01-30T00:00:00,1368,1368,0,1368
ΚΙΛΚΙΣ,203,120,54,60,174,2021-01-30T00:00:00,1771,1771,149,1920
ΚΟΖΑΝΗΣ,303,147,50,-1,197,2021-01-30T00:00:00,2277,2277,494,2771
ΚΟΡΙΝΘΙΑΣ,1003,102,54,12,156,2021-01-30T00:00:00,1498,1498,272,1770
ΚΩ,1206,72,0,36,72,2021-01-30T00:00:00,701,701,1,702
ΛΑΚΩΝΙΑΣ,1004,80,116,57,196,2021-01-30T00:00:00,1841,1841,348,2189
ΛΑΡΙΣΑΣ,502,263,54,-7,317,2021-01-30T00:00:00,4517,4517,1460,5977
ΛΑΣΙΘΙΟΥ,1302,156,115,-2,271,2021-01-30T00:00:00,2895,2895,266,3161
ΛΕΣΒΟΥ,1102,144,0,24,144,2021-01-30T00:00:00,1855,1855,0,1855
ΛΕΥΚΑΔΑΣ,605,48,0,0,48,2021-01-30T00:00:00,735,735,0,735
ΛΗΜΝΟΥ,1103,48,0,18,48,2021-01-30T00:00:00,568,568,0,568
ΜΑΓΝΗΣΙΑΣ,503,240,91,121,331,2021-01-30T00:00:00,2554,2554,136,2690
ΜΕΣΣΗΝΙΑΣ,1005,112,174,16,286,2021-01-30T00:00:00,2910,2910,364,3274
ΜΗΛΟΥ,1207,6,0,0,6,2021-01-30T00:00:00,24,24,0,24
ΜΥΚΟΝΟΥ,1208,36,0,18,36,2021-01-30T00:00:00,90,90,0,90
ΝΑΞΟΥ,1209,36,0,24,36,2021-01-30T00:00:00,324,324,0,324
ΝΗΣΩΝ,906,210,0,53,210,2021-01-30T00:00:00,702,702,0,702
ΝΟΤΙΟΥ ΤΟΜΕΑ ΑΘΗΝΩΝ,907,288,0,-6,288,2021-01-30T00:00:00,4377,4377,1,4378
ΞΑΝΘΗΣ,105,60,78,18,138,2021-01-30T00:00:00,1649,1649,153,1802
ΠΑΡΟΥ,1210,36,0,6,36,2021-01-30T00:00:00,108,108,0,108
ΠΕΙΡΑΙΩΣ,908,378,420,34,798,2021-01-30T00:00:00,8905,8905,1255,10160
ΠΕΛΛΑΣ,204,214,20,-12,234,2021-01-30T00:00:00,2505,2505,487,2992
ΠΙΕΡΙΑΣ,205,158,16,0,174,2021-01-30T00:00:00,1878,1878,317,2195
ΠΡΕΒΕΖΑΣ,404,0,72,-6,72,2021-01-30T00:00:00,847,847,191,1038
ΡΕΘΥΜΝΟΥ,1303,133,47,40,180,2021-01-30T00:00:00,1840,1840,95,1935
ΡΟΔΟΠΗΣ,106,50,46,0,96,2021-01-30T00:00:00,1265,1265,94,1359
ΡΟΔΟΥ,1211,102,0,-35,102,2021-01-30T00:00:00,1860,1860,0,1860
ΣΑΜΟΥ,1104,54,0,12,54,2021-01-30T00:00:00,687,687,3,690
ΣΕΡΡΩΝ,206,51,93,6,144,2021-01-30T00:00:00,2022,2022,187,2209
ΣΠΟΡΑΔΩΝ,504,48,0,6,48,2021-01-30T00:00:00,132,132,0,132
ΣΥΡΟΥ,1212,30,0,-6,30,2021-01-30T00:00:00,628,628,0,628
ΤΗΝΟΥ,1213,37,0,-11,37,2021-01-30T00:00:00,131,131,0,131
ΤΡΙΚΑΛΩΝ,505,136,50,-12,186,2021-01-30T00:00:00,2542,2542,537,3079
ΦΘΙΩΤΙΔΑΣ,804,92,88,0,180,2021-01-30T00:00:00,2487,2487,232,2719
ΦΛΩΡΙΝΑΣ,304,38,58,6,96,2021-01-30T00:00:00,1114,1114,108,1222
ΦΩΚΙΔΑΣ,805,5,43,0,48,2021-01-30T00:00:00,608,608,88,696
ΧΑΛΚΙΔΙΚΗΣ,207,67,47,-12,114,2021-01-30T00:00:00,1387,1387,98,1485
ΧΑΝΙΩΝ,1304,287,87,-11,374,2021-01-30T00:00:00,3957,3957,841,4798
ΧΙΟΥ,1105,54,0,-6,54,2021-01-30T00:00:00,845,845,0,845
ΑΙΤΩΛΟΑΚΑΡΝΑΝΙΑΣ,701,112,140,66,252,2021-02-01T00:00:00,2196,2196,538,2734
ΑΝΑΤΟΛΙΚΗΣ ΑΤΤΙΚΗΣ,901,525,0,82,525,2021-02-01T00:00:00,5208,5208,616,5824
ΑΝΔΡΟΥ,1201,54,0,54,54,2021-02-01T00:00:00,162,162,0,162
ΑΡΓΟΛΙΔΑΣ,1001,110,59,28,169,2021-02-01T00:00:00,1913,1913,256,2169
ΑΡΚΑΔΙΑΣ,1002,62,124,-17,186,2021-02-01T00:00:00,1895,1895,426,2321
ΑΡΤΑΣ,401,115,77,42,192,2021-02-01T00:00:00,1980,1980,430,2410
ΑΧΑΪΑΣ,702,619,16,108,635,2021-02-01T00:00:00,6994,6994,1638,8632
ΒΟΙΩΤΙΑΣ,801,111,98,35,209,2021-02-01T00:00:00,1902,1902,281,2183
ΒΟΡΕΙΟΥ ΤΟΜΕΑ ΑΘΗΝΩΝ,902,1372,1304,1610,2676,2021-02-01T00:00:00,32090,32090,4794,36884
ΓΡΕΒΕΝΩΝ,301,6,48,6,54,2021-02-01T00:00:00,688,688,135,823
ΔΡΑΜΑΣ,101,90,96,42,186,2021-02-01T00:00:00,1961,1961,284,2245
ΔΥΤΙΚΗΣ ΑΤΤΙΚΗΣ,903,318,23,126,341,2021-02-01T00:00:00,2543,2543,441,2984
ΔΥΤΙΚΟΥ ΤΟΜΕΑ ΑΘΗΝΩΝ,904,645,484,193,1129,2021-02-01T00:00:00,9730,9730,2180,11910
ΕΒΡΟΥ,102,84,198,49,282,2021-02-01T00:00:00,3850,3850,433,4283
ΕΥΒΟΙΑΣ,802,346,124,86,470,2021-02-01T00:00:00,4347,4347,425,4772
ΕΥΡΥΤΑΝΙΑΣ,803,19,35,12,54,2021-02-01T00:00:00,470,470,119,589
ΖΑΚΥΝΘΟΥ,601,89,0,23,89,2021-02-01T00:00:00,1094,1094,0,1094
ΗΛΕΙΑΣ,703,139,136,2,275,2021-02-01T00:00:00,2577,2577,457,3034
ΗΜΑΘΙΑΣ,201,116,106,36,222,2021-02-01T00:00:00,2430,2430,496,2926
ΗΡΑΚΛΕΙΟΥ,1301,295,237,70,532,2021-02-01T00:00:00,7385,7385,1156,8541
ΘΑΣΟΥ,103,47,0,5,47,2021-02-01T00:00:00,179,179,0,179
ΘΕΣΠΡΩΤΙΑΣ,402,57,45,6,102,2021-02-01T00:00:00,1328,1328,220,1548
ΘΕΣΣΑΛΟΝΙΚΗΣ,202,1539,648,371,2187,2021-02-01T00:00:00,26876,26876,6101,32977
ΘΗΡΑΣ,1202,31,5,12,36,2021-02-01T00:00:00,276,276,5,281
ΙΘΑΚΗΣ,602,0,0,0,0,2021-02-01T00:00:00,0,0,0,0
ΙΚΑΡΙΑΣ,1101,35,1,-12,36,2021-02-01T00:00:00,319,319,2,321
ΙΩΑΝΝΙΝΩΝ,403,220,295,81,515,2021-02-01T00:00:00,5645,5645,1816,7461
ΚΑΒΑΛΑΣ,104,124,116,66,240,2021-02-01T00:00:00,2676,2676,303,2979
ΚΑΛΥΜΝΟΥ,1203,36,0,-18,36,2021-02-01T00:00:00,612,612,1,613
ΚΑΡΔΙΤΣΑΣ,501,252,0,24,252,2021-02-01T00:00:00,2695,2695,534,3229
ΚΑΡΠΑΘΟΥ,1204,30,0,18,30,2021-02-01T00:00:00,225,225,0,225
ΚΑΣΤΟΡΙΑΣ,302,59,48,11,107,2021-02-01T00:00:00,1271,1271,143,1414
ΚΕΑΣ-ΚΥΘΝΟΥ,1205,0,0,0,0,2021-02-01T00:00:00,0,0,0,0
ΚΕΝΤΡΙΚΟΥ ΤΟΜΕΑ ΑΘΗΝΩΝ,905,1813,1341,365,3154,2021-02-01T00:00:00,37786,37786,12285,50071
ΚΕΡΚΥΡΑΣ,603,121,65,90,186,2021-02-01T00:00:00,2283,2283,65,2348
ΚΕΦΑΛΛΗΝΙΑΣ,604,110,20,5,130,2021-02-01T00:00:00,1478,1478,20,1498
ΚΙΛΚΙΣ,203,147,63,36,210,2021-02-01T00:00:00,1918,1918,212,2130
ΚΟΖΑΝΗΣ,303,119,95,17,214,2021-02-01T00:00:00,2396,2396,589,2985
ΚΟΡΙΝΘΙΑΣ,1003,164,4,12,168,2021-02-01T00:00:00,1662,1662,276,1938
ΚΩ,1206,137,0,65,137,2021-02-01T00:00:00,838,838,1,839
ΛΑΚΩΝΙΑΣ,1004,199,14,17,213,2021-02-01T00:00:00,2040,2040,362,2402
ΛΑΡΙΣΑΣ,502,311,86,80,397,2021-02-01T00:00:00,4828,4828,1546,6374
ΛΑΣΙΘΙΟΥ,1302,220,86,35,306,2021-02-01T00:00:00,3115,3115,352,3467
ΛΕΣΒΟΥ,1102,167,0,23,167,2021-02-01T00:00:00,2022,2022,0,2022
ΛΕΥΚΑΔΑΣ,605,24,30,6,54,2021-02-01T00:00:00,759,759,30,789
ΛΗΜΝΟΥ,1103,60,0,12,60,2021-02-01T00:00:00,628,628,0,628
ΜΑΓΝΗΣΙΑΣ,503,264,95,28,359,2021-02-01T00:00:00,2818,2818,231,3049
ΜΕΣΣΗΝΙΑΣ,1005,200,133,47,333,2021-02-01T00:00:00,3110,3110,497,3607
ΜΗΛΟΥ,1207,31,0,25,31,2021-02-01T00:00:00,55,55,0,55
ΜΥΚΟΝΟΥ,1208,36,0,0,36,2021-02-01T00:00:00,126,126,0,126
ΝΑΞΟΥ,1209,48,0,12,48,2021-02-01T00:00:00,372,372,0,372
ΝΗΣΩΝ,906,209,0,-1,209,2021-02-01T00:00:00,911,911,0,911
ΝΟΤΙΟΥ ΤΟΜΕΑ ΑΘΗΝΩΝ,907,288,28,28,316,2021-02-01T00:00:00,4665,4665,29,4694
ΞΑΝΘΗΣ,105,17,145,24,162,2021-02-01T00:00:00,1666,1666,298,1964
ΠΑΡΟΥ,1210,48,0,12,48,2021-02-01T00:00:00,156,156,0,156
ΠΕΙΡΑΙΩΣ,908,553,286,41,839,2021-02-01T00:00:00,9458,9458,1541,10999
ΠΕΛΛΑΣ,204,272,34,72,306,2021-02-01T00:00:00,2777,2777,521,3298
ΠΙΕΡΙΑΣ,205,179,31,36,210,2021-02-01T00:00:00,2057,2057,348,2405
ΠΡΕΒΕΖΑΣ,404,3,75,6,78,2021-02-01T00:00:00,850,850,266,1116
ΡΕΘΥΜΝΟΥ,1303,146,46,12,192,2021-02-01T00:00:00,1986,1986,141,2127
ΡΟΔΟΠΗΣ,106,59,49,12,108,2021-02-01T00:00:00,1324,1324,143,1467
ΡΟΔΟΥ,1211,107,0,5,107,2021-02-01T00:00:00,1967,1967,0,1967
ΣΑΜΟΥ,1104,54,0,0,54,2021-02-01T00:00:00,741,741,3,744
ΣΕΡΡΩΝ,206,80,94,30,174,2021-02-01T00:00:00,2102,2102,281,2383
ΣΠΟΡΑΔΩΝ,504,54,0,6,54,2021-02-01T00:00:00,186,186,0,186
ΣΥΡΟΥ,1212,59,1,30,60,2021-02-01T00:00:00,687,687,1,688
ΤΗΝΟΥ,1213,47,1,11,48,2021-02-01T00:00:00,178,178,1,179
ΤΡΙΚΑΛΩΝ,505,138,79,31,217,2021-02-01T00:00:00,2680,2680,616,3296
ΦΘΙΩΤΙΔΑΣ,804,125,97,42,222,2021-02-01T00:00:00,2612,2612,329,2941
ΦΛΩΡΙΝΑΣ,304,55,71,30,126,2021-02-01T00:00:00,1169,1169,179,1348
ΦΩΚΙΔΑΣ,805,39,15,6,54,2021-02-01T00:00:00,647,647,103,750
ΧΑΛΚΙΔΙΚΗΣ,207,98,58,42,156,2021-02-01T00:00:00,1485,1485,156,1641
ΧΑΝΙΩΝ,1304,340,73,39,413,2021-02-01T00:00:00,4297,4297,914,5211
ΧΙΟΥ,1105,54,0,0,54,2021-02-01T00:00:00,899,899,0,899
ΑΙΤΩΛΟΑΚΑΡΝΑΝΙΑΣ,701,121,119,-12,240,2021-02-02T00:00:00,2317,2317,657,2974
ΑΝΑΤΟΛΙΚΗΣ ΑΤΤΙΚΗΣ,901,525,0,0,525,2021-02-02T00:00:00,5733,5733,616,6349
ΑΝΔΡΟΥ,1201,42,0,-12,42,2021-02-02T00:00:00,204,204,0,204
ΑΡΓΟΛΙΔΑΣ,1001,165,3,-1,168,2021-02-02T00:00:00,2078,2078,259,2337
ΑΡΚΑΔΙΑΣ,1002,109,47,-30,156,2021-02-02T00:00:00,2004,2004,473,2477
ΑΡΤΑΣ,401,109,76,-7,185,2021-02-02T00:00:00,2089,2089,506,2595
ΑΧΑΪΑΣ,702,433,103,-99,536,2021-02-02T00:00:00,7427,7427,1741,9168
ΒΟΙΩΤΙΑΣ,801,89,69,-51,158,2021-02-02T00:00:00,1991,1991,350,2341
ΒΟΡΕΙΟΥ ΤΟΜΕΑ ΑΘΗΝΩΝ,902,1167,1273,-236,2440,2021-02-02T00:00:00,33257,33257,6067,39324
ΓΡΕΒΕΝΩΝ,301,5,49,0,54,2021-02-02T00:00:00,693,693,184,877
ΔΡΑΜΑΣ,101,64,86,-36,150,2021-02-02T00:00:00,2025,2025,370,2395
ΔΥΤΙΚΗΣ ΑΤΤΙΚΗΣ,903,190,25,-126,215,2021-02-02T00:00:00,2733,2733,466,3199
ΔΥΤΙΚΟΥ ΤΟΜΕΑ ΑΘΗΝΩΝ,904,714,106,-309,820,2021-02-02T00:00:00,10444,10444,2286,12730
ΕΒΡΟΥ,102,87,243,48,330,2021-02-02T00:00:00,3937,3937,676,4613
ΕΥΒΟΙΑΣ,802,218,138,-114,356,2021-02-02T00:00:00,4565,4565,563,5128
ΕΥΡΥΤΑΝΙΑΣ,803,24,24,-6,48,2021-02-02T00:00:00,494,494,143,637
ΖΑΚΥΝΘΟΥ,601,55,48,14,103,2021-02-02T00:00:00,1149,1149,48,1197
ΗΛΕΙΑΣ,703,192,46,-37,238,2021-02-02T00:00:00,2769,2769,503,3272
ΗΜΑΘΙΑΣ,201,159,69,6,228,2021-02-02T00:00:00,2589,2589,565,3154
ΗΡΑΚΛΕΙΟΥ,1301,305,241,14,546,2021-02-02T00:00:00,7690,7690,1397,9087
ΘΑΣΟΥ,103,48,0,1,48,2021-02-02T00:00:00,227,227,0,227
ΘΕΣΠΡΩΤΙΑΣ,402,101,0,-1,101,2021-02-02T00:00:00,1429,1429,220,1649
ΘΕΣΣΑΛΟΝΙΚΗΣ,202,1602,829,244,2431,2021-02-02T00:00:00,28478,28478,6930,35408
ΘΗΡΑΣ,1202,11,13,-12,24,2021-02-02T00:00:00,287,287,18,305
ΙΘΑΚΗΣ,602,0,0,0,0,2021-02-02T00:00:00,0,0,0,0
ΙΚΑΡΙΑΣ,1101,8,22,-6,30,2021-02-02T00:00:00,327,327,24,351
ΙΩΑΝΝΙΝΩΝ,403,135,255,-125,390,2021-02-02T00:00:00,5780,5780,2071,7851
ΚΑΒΑΛΑΣ,104,118,122,0,240,2021-02-02T00:00:00,2794,2794,425,3219
ΚΑΛΥΜΝΟΥ,1203,44,10,18,54,2021-02-02T00:00:00,656,656,11,667
ΚΑΡΔΙΤΣΑΣ,501,252,0,0,252,2021-02-02T00:00:00,2947,2947,534,3481
ΚΑΡΠΑΘΟΥ,1204,8,10,-12,18,2021-02-02T00:00:00,233,233,10,243
ΚΑΣΤΟΡΙΑΣ,302,61,48,2,109,2021-02-02T00:00:00,1332,1332,191,1523
ΚΕΑΣ-ΚΥΘΝΟΥ,1205,0,0,0,0,2021-02-02T00:00:00,0,0,0,0
ΚΕΝΤΡΙΚΟΥ ΤΟΜΕΑ ΑΘΗΝΩΝ,905,2249,1553,648,3802,2021-02-02T00:00:00,40035,40035,13838,53873
ΚΕΡΚΥΡΑΣ,603,107,97,18,204,2021-02-02T00:00:00,2390,2390,162,2552
ΚΕΦΑΛΛΗΝΙΑΣ,604,31,90,-9,121,2021-02-02T00:00:00,1509,1509,110,1619
ΚΙΛΚΙΣ,203,126,43,-41,169,2021-02-02T00:00:00,2044,2044,255,2299
ΚΟΖΑΝΗΣ,303,172,38,-4,210,2021-02-02T00:00:00,2568,2568,627,3195
ΚΟΡΙΝΘΙΑΣ,1003,146,10,-12,156,2021-02-02T00:00:00,1808,1808,286,2094
ΚΩ,1206,66,0,-71,66,2021-02-02T00:00:00,904,904,1,905
ΛΑΚΩΝΙΑΣ,1004,94,2,-117,96,2021-02-02T00:00:00,2134,2134,364,2498
ΛΑΡΙΣΑΣ,502,319,114,36,433,2021-02-02T00:00:00,5147,5147,1660,6807
ΛΑΣΙΘΙΟΥ,1302,223,50,-33,273,2021-02-02T00:00:00,3338,3338,402,3740
ΛΕΣΒΟΥ,1102,88,68,-11,156,2021-02-02T00:00:00,2110,2110,68,2178
ΛΕΥΚΑΔΑΣ,605,5,49,0,54,2021-02-02T00:00:00,764,764,79,843
ΛΗΜΝΟΥ,1103,17,43,0,60,2021-02-02T00:00:00,645,645,43,688
ΜΑΓΝΗΣΙΑΣ,503,247,98,-14,345,2021-02-02T00:00:00,3065,3065,329,3394
ΜΕΣΣΗΝΙΑΣ,1005,225,53,-55,278,2021-02-02T00:00:00,3335,3335,550,3885
ΜΗΛΟΥ,1207,24,0,-7,24,2021-02-02T00:00:00,79,79,0,79
ΜΥΚΟΝΟΥ,1208,18,0,-18,18,2021-02-02T00:00:00,144,144,0,144
ΝΑΞΟΥ,1209,14,34,0,48,2021-02-02T00:00:00,386,386,34,420
ΝΗΣΩΝ,906,183,25,-1,208,2021-02-02T00:00:00,1094,1094,25,1119
ΝΟΤΙΟΥ ΤΟΜΕΑ ΑΘΗΝΩΝ,907,306,88,78,394,2021-02-02T00:00:00,4971,4971,117,5088
ΞΑΝΘΗΣ,105,62,118,18,180,2021-02-02T00:00:00,1728,1728,416,2144
ΠΑΡΟΥ,1210,42,0,-6,42,2021-02-02T00:00:00,198,198,0,198
ΠΕΙΡΑΙΩΣ,908,619,247,27,866,2021-02-02T00:00:00,10077,10077,1788,11865
ΠΕΛΛΑΣ,204,294,0,-12,294,2021-02-02T00:00:00,3071,3071,521,3592
ΠΙΕΡΙΑΣ,205,232,21,43,253,2021-02-02T00:00:00,2289,2289,369,2658
ΠΡΕΒΕΖΑΣ,404,7,47,-24,54,2021-02-02T00:00:00,857,857,313,1170
ΡΕΘΥΜΝΟΥ,1303,132,60,0,192,2021-02-02T00:00:00,2118,2118,201,2319
ΡΟΔΟΠΗΣ,106,61,47,0,108,2021-02-02T00:00:00,1385,1385,190,1575
ΡΟΔΟΥ,1211,1,0,-106,1,2021-02-02T00:00:00,1968,1968,0,1968
ΣΑΜΟΥ,1104,6,60,12,66,2021-02-02T00:00:00,747,747,63,810
ΣΕΡΡΩΝ,206,60,96,-18,156,2021-02-02T00:00:00,2162,2162,377,2539
ΣΠΟΡΑΔΩΝ,504,12,0,-42,12,2021-02-02T00:00:00,198,198,0,198
ΣΥΡΟΥ,1212,7,44,-9,51,2021-02-02T00:00:00,694,694,45,739
ΤΗΝΟΥ,1213,36,0,-12,36,2021-02-02T00:00:00,214,214,1,215
ΤΡΙΚΑΛΩΝ,505,200,2,-15,202,2021-02-02T00:00:00,2880,2880,618,3498
ΦΘΙΩΤΙΔΑΣ,804,86,93,-43,179,2021-02-02T00:00:00,2698,2698,422,3120
ΦΛΩΡΙΝΑΣ,304,54,48,-24,102,2021-02-02T00:00:00,1223,1223,227,1450
ΦΩΚΙΔΑΣ,805,58,0,4,58,2021-02-02T00:00:00,705,705,103,808
ΧΑΛΚΙΔΙΚΗΣ,207,103,42,-11,145,2021-02-02T00:00:00,1588,1588,198,1786
ΧΑΝΙΩΝ,1304,396,2,-15,398,2021-02-02T00:00:00,4693,4693,916,5609
ΧΙΟΥ,1105,3,63,12,66,2021-02-02T00:00:00,902,902,63,965
ΑΙΤΩΛΟΑΚΑΡΝΑΝΙΑΣ,701,186,30,-24,216,2021-02-03T00:00:00,2503,2503,687,3190
ΑΝΑΤΟΛΙΚΗΣ ΑΤΤΙΚΗΣ,901,509,1,-15,510,2021-02-03T00:00:00,6242,6242,617,6859
ΑΝΔΡΟΥ,1201,35,0,-7,35,2021-02-03T00:00:00,239,239,0,239
ΑΡΓΟΛΙΔΑΣ,1001,166,1,-1,167,2021-02-03T00:00:00,2244,2244,260,2504
ΑΡΚΑΔΙΑΣ,1002,151,10,5,161,2021-02-03T00:00:00,2155,2155,483,2638
ΑΡΤΑΣ,401,151,36,2,187,2021-02-03T00:00:00,2240,2240,542,2782
ΑΧΑΪΑΣ,702,370,190,24,560,2021-02-03T00:00:00,7797,7797,1931,9728
ΒΟΙΩΤΙΑΣ,801,120,1,-37,121,2021-02-03T00:00:00,2111,2111,351,2462
ΒΟΡΕΙΟΥ ΤΟΜΕΑ ΑΘΗΝΩΝ,902,1328,1941,829,3269,2021-02-03T00:00:00,34585,34585,8008,42593
ΓΡΕΒΕΝΩΝ,301,45,9,0,54,2021-02-03T00:00:00,738,738,193,931
ΔΡΑΜΑΣ,101,150,0,0,150,2021-02-03T00:00:00,2175,2175,370,2545
ΔΥΤΙΚΗΣ ΑΤΤΙΚΗΣ,903,63,34,-118,97,2021-02-03T00:00:00,2796,2796,500,3296
ΔΥΤΙΚΟΥ ΤΟΜΕΑ ΑΘΗΝΩΝ,904,606,84,-130,690,2021-02-03T00:00:00,11050,11050,2370,13420
ΕΒΡΟΥ,102,156,150,-24,306,2021-02-03T00:00:00,4093,4093,826,4919
ΕΥΒΟΙΑΣ,802,301,2,-53,303,2021-02-03T00:00:00,4866,4866,565,5431
ΕΥΡΥΤΑΝΙΑΣ,803,42,0,-6,42,2021-02-03T00:00:00,536,536,143,679
ΖΑΚΥΝΘΟΥ,601,5,49,-49,54,2021-02-03T00:00:00,1154,1154,97,1251
ΗΛΕΙΑΣ,703,218,0,-20,218,2021-02-03T00:00:00,2987,2987,503,3490
ΗΜΑΘΙΑΣ,201,201,15,-12,216,2021-02-03T00:00:00,2790,2790,580,3370
ΗΡΑΚΛΕΙΟΥ,1301,286,241,-19,527,2021-02-03T00:00:00,7976,7976,1638,9614
ΘΑΣΟΥ,103,39,9,0,48,2021-02-03T00:00:00,266,266,9,275
ΘΕΣΠΡΩΤΙΑΣ,402,111,1,11,112,2021-02-03T00:00:00,1540,1540,221,1761
ΘΕΣΣΑΛΟΝΙΚΗΣ,202,1601,1165,335,2766,2021-02-03T00:00:00,30079,30079,8095,38174
ΘΗΡΑΣ,1202,11,1,-12,12,2021-02-03T00:00:00,298,298,19,317
ΙΘΑΚΗΣ,602,0,0,0,0,2021-02-03T00:00:00,0,0,0,0
ΙΚΑΡΙΑΣ,1101,24,6,0,30,2021-02-03T00:00:00,351,351,30,381
ΙΩΑΝΝΙΝΩΝ,403,260,189,59,449,2021-02-03T00:00:00,6040,6040,2260,8300
ΚΑΒΑΛΑΣ,104,115,131,6,246,2021-02-03T00:00:00,2909,2909,556,3465
ΚΑΛΥΜΝΟΥ,1203,8,86,40,94,2021-02-03T00:00:00,664,664,97,761
ΚΑΡΔΙΤΣΑΣ,501,245,1,-6,246,2021-02-03T00:00:00,3192,3192,535,3727
ΚΑΡΠΑΘΟΥ,1204,13,5,0,18,2021-02-03T00:00:00,246,246,15,261
ΚΑΣΤΟΡΙΑΣ,302,50,56,-3,106,2021-02-03T00:00:00,1382,1382,247,1629
ΚΕΑΣ-ΚΥΘΝΟΥ,1205,0,0,0,0,2021-02-03T00:00:00,0,0,0,0
ΚΕΝΤΡΙΚΟΥ ΤΟΜΕΑ ΑΘΗΝΩΝ,905,2471,1371,40,3842,2021-02-03T00:00:00,42506,42506,15209,57715
ΚΕΡΚΥΡΑΣ,603,115,34,-55,149,2021-02-03T00:00:00,2505,2505,196,2701
ΚΕΦΑΛΛΗΝΙΑΣ,604,20,63,-38,83,2021-02-03T00:00:00,1529,1529,173,1702
ΚΙΛΚΙΣ,203,101,49,-19,150,2021-02-03T00:00:00,2145,2145,304,2449
ΚΟΖΑΝΗΣ,303,190,14,-6,204,2021-02-03T00:00:00,2758,2758,641,3399
ΚΟΡΙΝΘΙΑΣ,1003,152,10,6,162,2021-02-03T00:00:00,1960,1960,296,2256
ΚΩ,1206,4,45,-17,49,2021-02-03T00:00:00,908,908,46,954
ΛΑΚΩΝΙΑΣ,1004,124,1,29,125,2021-02-03T00:00:00,2258,2258,365,2623
ΛΑΡΙΣΑΣ,502,361,30,-42,391,2021-02-03T00:00:00,5508,5508,1690,7198
ΛΑΣΙΘΙΟΥ,1302,149,48,-76,197,2021-02-03T00:00:00,3487,3487,450,3937
ΛΕΣΒΟΥ,1102,73,83,0,156,2021-02-03T00:00:00,2183,2183,151,2334
ΛΕΥΚΑΔΑΣ,605,39,15,0,54,2021-02-03T00:00:00,803,803,94,897
ΛΗΜΝΟΥ,1103,4,62,6,66,2021-02-03T00:00:00,649,649,105,754
ΜΑΓΝΗΣΙΑΣ,503,162,97,-86,259,2021-02-03T00:00:00,3227,3227,426,3653
ΜΕΣΣΗΝΙΑΣ,1005,251,1,-26,252,2021-02-03T00:00:00,3586,3586,551,4137
ΜΗΛΟΥ,1207,22,0,-2,22,2021-02-03T00:00:00,101,101,0,101
ΜΥΚΟΝΟΥ,1208,0,0,-18,0,2021-02-03T00:00:00,144,144,0,144
ΝΑΞΟΥ,1209,24,0,-24,24,2021-02-03T00:00:00,410,410,34,444
ΝΗΣΩΝ,906,121,0,-87,121,2021-02-03T00:00:00,1215,1215,25,1240
ΝΟΤΙΟΥ ΤΟΜΕΑ ΑΘΗΝΩΝ,907,300,276,182,576,2021-02-03T00:00:00,5271,5271,393,5664
ΞΑΝΘΗΣ,105,67,77,-36,144,2021-02-03T00:00:00,1795,1795,493,2288
ΠΑΡΟΥ,1210,30,0,-12,30,2021-02-03T00:00:00,228,228,0,228
ΠΕΙΡΑΙΩΣ,908,621,333,88,954,2021-02-03T00:00:00,10698,10698,2121,12819
ΠΕΛΛΑΣ,204,304,1,11,305,2021-02-03T00:00:00,3375,3375,522,3897
ΠΙΕΡΙΑΣ,205,199,10,-44,209,2021-02-03T00:00:00,2488,2488,379,2867
ΠΡΕΒΕΖΑΣ,404,49,5,0,54,2021-02-03T00:00:00,906,906,318,1224
ΡΕΘΥΜΝΟΥ,1303,69,81,-42,150,2021-02-03T00:00:00,2187,2187,282,2469
ΡΟΔΟΠΗΣ,106,49,71,12,120,2021-02-03T00:00:00,1434,1434,261,1695
ΡΟΔΟΥ,1211,11,209,219,220,2021-02-03T00:00:00,1979,1979,209,2188
ΣΑΜΟΥ,1104,4,50,-12,54,2021-02-03T00:00:00,751,751,113,864
ΣΕΡΡΩΝ,206,56,161,61,217,2021-02-03T00:00:00,2218,2218,538,2756
ΣΠΟΡΑΔΩΝ,504,3,3,-6,6,2021-02-03T00:00:00,201,201,3,204
ΣΥΡΟΥ,1212,3,51,3,54,2021-02-03T00:00:00,697,697,96,793
ΤΗΝΟΥ,1213,30,0,-6,30,2021-02-03T00:00:00,244,244,1,245
ΤΡΙΚΑΛΩΝ,505,200,15,13,215,2021-02-03T00:00:00,3080,3080,633,3713
ΦΘΙΩΤΙΔΑΣ,804,41,98,-40,139,2021-02-03T00:00:00,2739,2739,520,3259
ΦΛΩΡΙΝΑΣ,304,87,15,0,102,2021-02-03T00:00:00,1310,1310,242,1552
ΦΩΚΙΔΑΣ,805,52,0,-6,52,2021-02-03T00:00:00,757,757,103,860
ΧΑΛΚΙΔΙΚΗΣ,207,67,51,-27,118,2021-02-03T00:00:00,1655,1655,249,1904
ΧΑΝΙΩΝ,1304,363,0,-35,363,2021-02-03T00:00:00,5056,5056,916,5972
ΧΙΟΥ,1105,6,60,0,66,2021-02-03T00:00:00,908,908,123,1031
ΑΙΤΩΛΟΑΚΑΡΝΑΝΙΑΣ,701,0,0,0,0,2020-12-28T00:00:00,0,0,0,0
ΑΝΑΤΟΛΙΚΗΣ ΑΤΤΙΚΗΣ,901,55,0,20,55,2020-12-28T00:00:00,90,90,0,90
ΑΝΔΡΟΥ,1201,0,0,0,0,2020-12-28T00:00:00,0,0,0,0
ΑΡΓΟΛΙΔΑΣ,1001,0,0,0,0,2020-12-28T00:00:00,0,0,0,0
ΑΡΚΑΔΙΑΣ,1002,0,0,0,0,2020-12-28T00:00:00,0,0,0,0
ΑΡΤΑΣ,401,0,0,0,0,2020-12-28T00:00:00,0,0,0,0
ΑΧΑΪΑΣ,702,0,0,0,0,2020-12-28T00:00:00,0,0,0,0
ΒΟΙΩΤΙΑΣ,801,0,0,0,0,2020-12-28T00:00:00,0,0,0,0
ΒΟΡΕΙΟΥ ΤΟΜΕΑ ΑΘΗΝΩΝ,902,0,0,0,0,2020-12-28T00:00:00,0,0,0,0
ΓΡΕΒΕΝΩΝ,301,0,0,0,0,2020-12-28T00:00:00,0,0,0,0
ΔΡΑΜΑΣ,101,0,0,0,0,2020-12-28T00:00:00,0,0,0,0
ΔΥΤΙΚΗΣ ΑΤΤΙΚΗΣ,903,56,0,7,56,2020-12-28T00:00:00,105,105,0,105
ΔΥΤΙΚΟΥ ΤΟΜΕΑ ΑΘΗΝΩΝ,904,55,0,5,55,2020-12-28T00:00:00,105,105,0,105
ΕΒΡΟΥ,102,0,0,0,0,2020-12-28T00:00:00,0,0,0,0
ΕΥΒΟΙΑΣ,802,0,0,0,0,2020-12-28T00:00:00,0,0,0,0
ΕΥΡΥΤΑΝΙΑΣ,803,0,0,0,0,2020-12-28T00:00:00,0,0,0,0
ΖΑΚΥΝΘΟΥ,601,0,0,0,0,2020-12-28T00:00:00,0,0,0,0
ΗΛΕΙΑΣ,703,0,0,0,0,2020-12-28T00:00:00,0,0,0,0
ΗΜΑΘΙΑΣ,201,0,0,0,0,2020-12-28T00:00:00,0,0,0,0
ΗΡΑΚΛΕΙΟΥ,1301,0,0,0,0,2020-12-28T00:00:00,0,0,0,0
ΘΑΣΟΥ,103,0,0,0,0,2020-12-28T00:00:00,0,0,0,0
ΘΕΣΠΡΩΤΙΑΣ,402,0,0,0,0,2020-12-28T00:00:00,0,0,0,0
ΘΕΣΣΑΛΟΝΙΚΗΣ,202,0,0,0,0,2020-12-28T00:00:00,0,0,0,0
ΘΗΡΑΣ,1202,0,0,0,0,2020-12-28T00:00:00,0,0,0,0
ΙΘΑΚΗΣ,602,0,0,0,0,2020-12-28T00:00:00,0,0,0,0
ΙΚΑΡΙΑΣ,1101,0,0,0,0,2020-12-28T00:00:00,0,0,0,0
ΙΩΑΝΝΙΝΩΝ,403,0,0,0,0,2020-12-28T00:00:00,0,0,0,0
ΚΑΒΑΛΑΣ,104,0,0,0,0,2020-12-28T00:00:00,0,0,0,0
ΚΑΛΥΜΝΟΥ,1203,0,0,0,0,2020-12-28T00:00:00,0,0,0,0
ΚΑΡΔΙΤΣΑΣ,501,0,0,0,0,2020-12-28T00:00:00,0,0,0,0
ΚΑΡΠΑΘΟΥ,1204,0,0,0,0,2020-12-28T00:00:00,0,0,0,0
ΚΑΣΤΟΡΙΑΣ,302,0,0,0,0,2020-12-28T00:00:00,0,0,0,0
ΚΕΑΣ-ΚΥΘΝΟΥ,1205,0,0,0,0,2020-12-28T00:00:00,0,0,0,0
ΚΕΝΤΡΙΚΟΥ ΤΟΜΕΑ ΑΘΗΝΩΝ,905,61,0,-25,61,2020-12-28T00:00:00,147,147,0,147
ΚΕΡΚΥΡΑΣ,603,0,0,0,0,2020-12-28T00:00:00,0,0,0,0
ΚΕΦΑΛΛΗΝΙΑΣ,604,0,0,0,0,2020-12-28T00:00:00,0,0,0,0
ΚΙΛΚΙΣ,203,0,0,0,0,2020-12-28T00:00:00,0,0,0,0
ΚΟΖΑΝΗΣ,303,0,0,0,0,2020-12-28T00:00:00,0,0,0,0
ΚΟΡΙΝΘΙΑΣ,1003,0,0,0,0,2020-12-28T00:00:00,0,0,0,0
ΚΩ,1206,0,0,0,0,2020-12-28T00:00:00,0,0,0,0
ΛΑΚΩΝΙΑΣ,1004,0,0,0,0,2020-12-28T00:00:00,0,0,0,0
ΛΑΡΙΣΑΣ,502,0,0,0,0,2020-12-28T00:00:00,0,0,0,0
ΛΑΣΙΘΙΟΥ,1302,0,0,0,0,2020-12-28T00:00:00,0,0,0,0
ΛΕΣΒΟΥ,1102,0,0,0,0,2020-12-28T00:00:00,0,0,0,0
ΛΕΥΚΑΔΑΣ,605,0,0,0,0,2020-12-28T00:00:00,0,0,0,0
ΛΗΜΝΟΥ,1103,0,0,0,0,2020-12-28T00:00:00,0,0,0,0
ΜΑΓΝΗΣΙΑΣ,503,0,0,0,0,2020-12-28T00:00:00,0,0,0,0
ΜΕΣΣΗΝΙΑΣ,1005,0,0,0,0,2020-12-28T00:00:00,0,0,0,0
ΜΗΛΟΥ,1207,0,0,0,0,2020-12-28T00:00:00,0,0,0,0
ΜΥΚΟΝΟΥ,1208,0,0,0,0,2020-12-28T00:00:00,0,0,0,0
ΝΑΞΟΥ,1209,0,0,0,0,2020-12-28T00:00:00,0,0,0,0
ΝΗΣΩΝ,906,0,0,0,0,2020-12-28T00:00:00,0,0,0,0
ΝΟΤΙΟΥ ΤΟΜΕΑ ΑΘΗΝΩΝ,907,0,0,0,0,2020-12-28T00:00:00,0,0,0,0
ΞΑΝΘΗΣ,105,0,0,0,0,2020-12-28T00:00:00,0,0,0,0
ΠΑΡΟΥ,1210,0,0,0,0,2020-12-28T00:00:00,0,0,0,0
ΠΕΙΡΑΙΩΣ,908,0,0,0,0,2020-12-28T00:00:00,0,0,0,0
ΠΕΛΛΑΣ,204,0,0,0,0,2020-12-28T00:00:00,0,0,0,0
ΠΙΕΡΙΑΣ,205,0,0,0,0,2020-12-28T00:00:00,0,0,0,0
ΠΡΕΒΕΖΑΣ,404,0,0,0,0,2020-12-28T00:00:00,0,0,0,0
ΡΕΘΥΜΝΟΥ,1303,0,0,0,0,2020-12-28T00:00:00,0,0,0,0
ΡΟΔΟΠΗΣ,106,0,0,0,0,2020-12-28T00:00:00,0,0,0,0
ΡΟΔΟΥ,1211,0,0,0,0,2020-12-28T00:00:00,0,0,0,0
ΣΑΜΟΥ,1104,0,0,0,0,2020-12-28T00:00:00,0,0,0,0
ΣΕΡΡΩΝ,206,0,0,0,0,2020-12-28T00:00:00,0,0,0,0
ΣΠΟΡΑΔΩΝ,504,0,0,0,0,2020-12-28T00:00:00,0,0,0,0
ΣΥΡΟΥ,1212,0,0,0,0,2020-12-28T00:00:00,0,0,0,0
ΤΗΝΟΥ,1213,0,0,0,0,2020-12-28T00:00:00,0,0,0,0
ΤΡΙΚΑΛΩΝ,505,0,0,0,0,2020-12-28T00:00:00,0,0,0,0
ΦΘΙΩΤΙΔΑΣ,804,0,0,0,0,2020-12-28T00:00:00,0,0,0,0
ΦΛΩΡΙΝΑΣ,304,0,0,0,0,2020-12-28T00:00:00,0,0,0,0
ΦΩΚΙΔΑΣ,805,0,0,0,0,2020-12-28T00:00:00,0,0,0,0
ΧΑΛΚΙΔΙΚΗΣ,207,0,0,0,0,2020-12-28T00:00:00,0,0,0,0
ΧΑΝΙΩΝ,1304,0,0,0,0,2020-12-28T00:00:00,0,0,0,0
ΧΙΟΥ,1105,0,0,0,0,2020-12-28T00:00:00,0,0,0,0
ΑΙΤΩΛΟΑΚΑΡΝΑΝΙΑΣ,701,0,0,0,0,2020-12-29T00:00:00,0,0,0,0
ΑΝΑΤΟΛΙΚΗΣ ΑΤΤΙΚΗΣ,901,56,0,1,56,2020-12-29T00:00:00,146,146,0,146
ΑΝΔΡΟΥ,1201,0,0,0,0,2020-12-29T00:00:00,0,0,0,0
ΑΡΓΟΛΙΔΑΣ,1001,0,0,0,0,2020-12-29T00:00:00,0,0,0,0
ΑΡΚΑΔΙΑΣ,1002,0,0,0,0,2020-12-29T00:00:00,0,0,0,0
ΑΡΤΑΣ,401,0,0,0,0,2020-12-29T00:00:00,0,0,0,0
ΑΧΑΪΑΣ,702,114,0,114,114,2020-12-29T00:00:00,114,114,0,114
ΒΟΙΩΤΙΑΣ,801,0,0,0,0,2020-12-29T00:00:00,0,0,0,0
ΒΟΡΕΙΟΥ ΤΟΜΕΑ ΑΘΗΝΩΝ,902,0,0,0,0,2020-12-29T00:00:00,0,0,0,0
ΓΡΕΒΕΝΩΝ,301,0,0,0,0,2020-12-29T00:00:00,0,0,0,0
ΔΡΑΜΑΣ,101,0,0,0,0,2020-12-29T00:00:00,0,0,0,0
ΔΥΤΙΚΗΣ ΑΤΤΙΚΗΣ,903,45,0,-11,45,2020-12-29T00:00:00,150,150,0,150
ΔΥΤΙΚΟΥ ΤΟΜΕΑ ΑΘΗΝΩΝ,904,55,0,0,55,2020-12-29T00:00:00,160,160,0,160
ΕΒΡΟΥ,102,0,0,0,0,2020-12-29T00:00:00,0,0,0,0
ΕΥΒΟΙΑΣ,802,0,0,0,0,2020-12-29T00:00:00,0,0,0,0
ΕΥΡΥΤΑΝΙΑΣ,803,0,0,0,0,2020-12-29T00:00:00,0,0,0,0
ΖΑΚΥΝΘΟΥ,601,0,0,0,0,2020-12-29T00:00:00,0,0,0,0
ΗΛΕΙΑΣ,703,0,0,0,0,2020-12-29T00:00:00,0,0,0,0
ΗΜΑΘΙΑΣ,201,0,0,0,0,2020-12-29T00:00:00,0,0,0,0
ΗΡΑΚΛΕΙΟΥ,1301,0,0,0,0,2020-12-29T00:00:00,0,0,0,0
ΘΑΣΟΥ,103,0,0,0,0,2020-12-29T00:00:00,0,0,0,0
ΘΕΣΠΡΩΤΙΑΣ,402,0,0,0,0,2020-12-29T00:00:00,0,0,0,0
ΘΕΣΣΑΛΟΝΙΚΗΣ,202,58,0,58,58,2020-12-29T00:00:00,58,58,0,58
ΘΗΡΑΣ,1202,0,0,0,0,2020-12-29T00:00:00,0,0,0,0
ΙΘΑΚΗΣ,602,0,0,0,0,2020-12-29T00:00:00,0,0,0,0
ΙΚΑΡΙΑΣ,1101,0,0,0,0,2020-12-29T00:00:00,0,0,0,0
ΙΩΑΝΝΙΝΩΝ,403,77,0,77,77,2020-12-29T00:00:00,77,77,0,77
ΚΑΒΑΛΑΣ,104,0,0,0,0,2020-12-29T00:00:00,0,0,0,0
ΚΑΛΥΜΝΟΥ,1203,0,0,0,0,2020-12-29T00:00:00,0,0,0,0
ΚΑΡΔΙΤΣΑΣ,501,0,0,0,0,2020-12-29T00:00:00,0,0,0,0
ΚΑΡΠΑΘΟΥ,1204,0,0,0,0,2020-12-29T00:00:00,0,0,0,0
ΚΑΣΤΟΡΙΑΣ,302,0,0,0,0,2020-12-29T00:00:00,0,0,0,0
ΚΕΑΣ-ΚΥΘΝΟΥ,1205,0,0,0,0,2020-12-29T00:00:00,0,0,0,0
ΚΕΝΤΡΙΚΟΥ ΤΟΜΕΑ ΑΘΗΝΩΝ,905,120,0,59,120,2020-12-29T00:00:00,267,267,0,267
ΚΕΡΚΥΡΑΣ,603,0,0,0,0,2020-12-29T00:00:00,0,0,0,0
ΚΕΦΑΛΛΗΝΙΑΣ,604,0,0,0,0,2020-12-29T00:00:00,0,0,0,0
ΚΙΛΚΙΣ,203,0,0,0,0,2020-12-29T00:00:00,0,0,0,0
ΚΟΖΑΝΗΣ,303,0,0,0,0,2020-12-29T00:00:00,0,0,0,0
ΚΟΡΙΝΘΙΑΣ,1003,0,0,0,0,2020-12-29T00:00:00,0,0,0,0
ΚΩ,1206,0,0,0,0,2020-12-29T00:00:00,0,0,0,0
ΛΑΚΩΝΙΑΣ,1004,0,0,0,0,2020-12-29T00:00:00,0,0,0,0
ΛΑΡΙΣΑΣ,502,105,0,105,105,2020-12-29T00:00:00,105,105,0,105
ΛΑΣΙΘΙΟΥ,1302,0,0,0,0,2020-12-29T00:00:00,0,0,0,0
ΛΕΣΒΟΥ,1102,0,0,0,0,2020-12-29T00:00:00,0,0,0,0
ΛΕΥΚΑΔΑΣ,605,0,0,0,0,2020-12-29T00:00:00,0,0,0,0
ΛΗΜΝΟΥ,1103,0,0,0,0,2020-12-29T00:00:00,0,0,0,0
ΜΑΓΝΗΣΙΑΣ,503,0,0,0,0,2020-12-29T00:00:00,0,0,0,0
ΜΕΣΣΗΝΙΑΣ,1005,0,0,0,0,2020-12-29T00:00:00,0,0,0,0
ΜΗΛΟΥ,1207,0,0,0,0,2020-12-29T00:00:00,0,0,0,0
ΜΥΚΟΝΟΥ,1208,0,0,0,0,2020-12-29T00:00:00,0,0,0,0
ΝΑΞΟΥ,1209,0,0,0,0,2020-12-29T00:00:00,0,0,0,0
ΝΗΣΩΝ,906,0,0,0,0,2020-12-29T00:00:00,0,0,0,0
ΝΟΤΙΟΥ ΤΟΜΕΑ ΑΘΗΝΩΝ,907,0,0,0,0,2020-12-29T00:00:00,0,0,0,0
ΞΑΝΘΗΣ,105,0,0,0,0,2020-12-29T00:00:00,0,0,0,0
ΠΑΡΟΥ,1210,0,0,0,0,2020-12-29T00:00:00,0,0,0,0
ΠΕΙΡΑΙΩΣ,908,0,0,0,0,2020-12-29T00:00:00,0,0,0,0
ΠΕΛΛΑΣ,204,0,0,0,0,2020-12-29T00:00:00,0,0,0,0
ΠΙΕΡΙΑΣ,205,0,0,0,0,2020-12-29T00:00:00,0,0,0,0
ΠΡΕΒΕΖΑΣ,404,0,0,0,0,2020-12-29T00:00:00,0,0,0,0
ΡΕΘΥΜΝΟΥ,1303,0,0,0,0,2020-12-29T00:00:00,0,0,0,0
ΡΟΔΟΠΗΣ,106,0,0,0,0,2020-12-29T00:00:00,0,0,0,0
ΡΟΔΟΥ,1211,0,0,0,0,2020-12-29T00:00:00,0,0,0,0
ΣΑΜΟΥ,1104,0,0,0,0,2020-12-29T00:00:00,0,0,0,0
ΣΕΡΡΩΝ,206,0,0,0,0,2020-12-29T00:00:00,0,0,0,0
ΣΠΟΡΑΔΩΝ,504,0,0,0,0,2020-12-29T00:00:00,0,0,0,0
ΣΥΡΟΥ,1212,0,0,0,0,2020-12-29T00:00:00,0,0,0,0
ΤΗΝΟΥ,1213,0,0,0,0,2020-12-29T00:00:00,0,0,0,0
ΤΡΙΚΑΛΩΝ,505,0,0,0,0,2020-12-29T00:00:00,0,0,0,0
ΦΘΙΩΤΙΔΑΣ,804,0,0,0,0,2020-12-29T00:00:00,0,0,0,0
ΦΛΩΡΙΝΑΣ,304,0,0,0,0,2020-12-29T00:00:00,0,0,0,0
ΦΩΚΙΔΑΣ,805,0,0,0,0,2020-12-29T00:00:00,0,0,0,0
ΧΑΛΚΙΔΙΚΗΣ,207,0,0,0,0,2020-12-29T00:00:00,0,0,0,0
ΧΑΝΙΩΝ,1304,0,0,0,0,2020-12-29T00:00:00,0,0,0,0
ΧΙΟΥ,1105,0,0,0,0,2020-12-29T00:00:00,0,0,0,0
ΑΙΤΩΛΟΑΚΑΡΝΑΝΙΑΣ,701,0,0,0,0,2020-12-30T00:00:00,0,0,0,0
ΑΝΑΤΟΛΙΚΗΣ ΑΤΤΙΚΗΣ,901,40,0,-16,40,2020-12-30T00:00:00,186,186,0,186
ΑΝΔΡΟΥ,1201,0,0,0,0,2020-12-30T00:00:00,0,0,0,0
ΑΡΓΟΛΙΔΑΣ,1001,0,0,0,0,2020-12-30T00:00:00,0,0,0,0
ΑΡΚΑΔΙΑΣ,1002,0,0,0,0,2020-12-30T00:00:00,0,0,0,0
ΑΡΤΑΣ,401,0,0,0,0,2020-12-30T00:00:00,0,0,0,0
ΑΧΑΪΑΣ,702,97,0,-17,97,2020-12-30T00:00:00,211,211,0,211
ΒΟΙΩΤΙΑΣ,801,0,0,0,0,2020-12-30T00:00:00,0,0,0,0
ΒΟΡΕΙΟΥ ΤΟΜΕΑ ΑΘΗΝΩΝ,902,0,0,0,0,2020-12-30T00:00:00,0,0,0,0
ΓΡΕΒΕΝΩΝ,301,0,0,0,0,2020-12-30T00:00:00,0,0,0,0
ΔΡΑΜΑΣ,101,0,0,0,0,2020-12-30T00:00:00,0,0,0,0
ΔΥΤΙΚΗΣ ΑΤΤΙΚΗΣ,903,49,0,4,49,2020-12-30T00:00:00,199,199,0,199
ΔΥΤΙΚΟΥ ΤΟΜΕΑ ΑΘΗΝΩΝ,904,40,0,-15,40,2020-12-30T00:00:00,200,200,0,200
ΕΒΡΟΥ,102,0,0,0,0,2020-12-30T00:00:00,0,0,0,0
ΕΥΒΟΙΑΣ,802,0,0,0,0,2020-12-30T00:00:00,0,0,0,0
ΕΥΡΥΤΑΝΙΑΣ,803,0,0,0,0,2020-12-30T00:00:00,0,0,0,0
ΖΑΚΥΝΘΟΥ,601,0,0,0,0,2020-12-30T00:00:00,0,0,0,0
ΗΛΕΙΑΣ,703,0,0,0,0,2020-12-30T00:00:00,0,0,0,0
ΗΜΑΘΙΑΣ,201,0,0,0,0,2020-12-30T00:00:00,0,0,0,0
ΗΡΑΚΛΕΙΟΥ,1301,0,0,0,0,2020-12-30T00:00:00,0,0,0,0
ΘΑΣΟΥ,103,0,0,0,0,2020-12-30T00:00:00,0,0,0,0
ΘΕΣΠΡΩΤΙΑΣ,402,0,0,0,0,2020-12-30T00:00:00,0,0,0,0
ΘΕΣΣΑΛΟΝΙΚΗΣ,202,79,0,21,79,2020-12-30T00:00:00,137,137,0,137
ΘΗΡΑΣ,1202,0,0,0,0,2020-12-30T00:00:00,0,0,0,0
ΙΘΑΚΗΣ,602,0,0,0,0,2020-12-30T00:00:00,0,0,0,0
ΙΚΑΡΙΑΣ,1101,0,0,0,0,2020-12-30T00:00:00,0,0,0,0
ΙΩΑΝΝΙΝΩΝ,403,100,0,23,100,2020-12-30T00:00:00,177,177,0,177
ΚΑΒΑΛΑΣ,104,0,0,0,0,2020-12-30T00:00:00,0,0,0,0
ΚΑΛΥΜΝΟΥ,1203,0,0,0,0,2020-12-30T00:00:00,0,0,0,0
ΚΑΡΔΙΤΣΑΣ,501,0,0,0,0,2020-12-30T00:00:00,0,0,0,0
ΚΑΡΠΑΘΟΥ,1204,0,0,0,0,2020-12-30T00:00:00,0,0,0,0
ΚΑΣΤΟΡΙΑΣ,302,0,0,0,0,2020-12-30T00:00:00,0,0,0,0
ΚΕΑΣ-ΚΥΘΝΟΥ,1205,0,0,0,0,2020-12-30T00:00:00,0,0,0,0
ΚΕΝΤΡΙΚΟΥ ΤΟΜΕΑ ΑΘΗΝΩΝ,905,95,0,-25,95,2020-12-30T00:00:00,362,362,0,362
ΚΕΡΚΥΡΑΣ,603,0,0,0,0,2020-12-30T00:00:00,0,0,0,0
ΚΕΦΑΛΛΗΝΙΑΣ,604,0,0,0,0,2020-12-30T00:00:00,0,0,0,0
ΚΙΛΚΙΣ,203,0,0,0,0,2020-12-30T00:00:00,0,0,0,0
ΚΟΖΑΝΗΣ,303,0,0,0,0,2020-12-30T00:00:00,0,0,0,0
ΚΟΡΙΝΘΙΑΣ,1003,0,0,0,0,2020-12-30T00:00:00,0,0,0,0
ΚΩ,1206,0,0,0,0,2020-12-30T00:00:00,0,0,0,0
ΛΑΚΩΝΙΑΣ,1004,0,0,0,0,2020-12-30T00:00:00,0,0,0,0
ΛΑΡΙΣΑΣ,502,145,0,40,145,2020-12-30T00:00:00,250,250,0,250
ΛΑΣΙΘΙΟΥ,1302,0,0,0,0,2020-12-30T00:00:00,0,0,0,0
ΛΕΣΒΟΥ,1102,0,0,0,0,2020-12-30T00:00:00,0,0,0,0
ΛΕΥΚΑΔΑΣ,605,0,0,0,0,2020-12-30T00:00:00,0,0,0,0
ΛΗΜΝΟΥ,1103,0,0,0,0,2020-12-30T00:00:00,0,0,0,0
ΜΑΓΝΗΣΙΑΣ,503,0,0,0,0,2020-12-30T00:00:00,0,0,0,0
ΜΕΣΣΗΝΙΑΣ,1005,0,0,0,0,2020-12-30T00:00:00,0,0,0,0
ΜΗΛΟΥ,1207,0,0,0,0,2020-12-30T00:00:00,0,0,0,0
ΜΥΚΟΝΟΥ,1208,0,0,0,0,2020-12-30T00:00:00,0,0,0,0
ΝΑΞΟΥ,1209,0,0,0,0,2020-12-30T00:00:00,0,0,0,0
ΝΗΣΩΝ,906,0,0,0,0,2020-12-30T00:00:00,0,0,0,0
ΝΟΤΙΟΥ ΤΟΜΕΑ ΑΘΗΝΩΝ,907,0,0,0,0,2020-12-30T00:00:00,0,0,0,0
ΞΑΝΘΗΣ,105,0,0,0,0,2020-12-30T00:00:00,0,0,0,0
ΠΑΡΟΥ,1210,0,0,0,0,2020-12-30T00:00:00,0,0,0,0
ΠΕΙΡΑΙΩΣ,908,0,0,0,0,2020-12-30T00:00:00,0,0,0,0
ΠΕΛΛΑΣ,204,0,0,0,0,2020-12-30T00:00:00,0,0,0,0
ΠΙΕΡΙΑΣ,205,0,0,0,0,2020-12-30T00:00:00,0,0,0,0
ΠΡΕΒΕΖΑΣ,404,0,0,0,0,2020-12-30T00:00:00,0,0,0,0
ΡΕΘΥΜΝΟΥ,1303,0,0,0,0,2020-12-30T00:00:00,0,0,0,0
ΡΟΔΟΠΗΣ,106,0,0,0,0,2020-12-30T00:00:00,0,0,0,0
ΡΟΔΟΥ,1211,0,0,0,0,2020-12-30T00:00:00,0,0,0,0
ΣΑΜΟΥ,1104,0,0,0,0,2020-12-30T00:00:00,0,0,0,0
ΣΕΡΡΩΝ,206,0,0,0,0,2020-12-30T00:00:00,0,0,0,0
ΣΠΟΡΑΔΩΝ,504,0,0,0,0,2020-12-30T00:00:00,0,0,0,0
ΣΥΡΟΥ,1212,0,0,0,0,2020-12-30T00:00:00,0,0,0,0
ΤΗΝΟΥ,1213,0,0,0,0,2020-12-30T00:00:00,0,0,0,0
ΤΡΙΚΑΛΩΝ,505,0,0,0,0,2020-12-30T00:00:00,0,0,0,0
ΦΘΙΩΤΙΔΑΣ,804,0,0,0,0,2020-12-30T00:00:00,0,0,0,0
ΦΛΩΡΙΝΑΣ,304,0,0,0,0,2020-12-30T00:00:00,0,0,0,0
ΦΩΚΙΔΑΣ,805,0,0,0,0,2020-12-30T00:00:00,0,0,0,0
ΧΑΛΚΙΔΙΚΗΣ,207,0,0,0,0,2020-12-30T00:00:00,0,0,0,0
ΧΑΝΙΩΝ,1304,0,0,0,0,2020-12-30T00:00:00,0,0,0,0
ΧΙΟΥ,1105,0,0,0,0,2020-12-30T00:00:00,0,0,0,0
ΑΙΤΩΛΟΑΚΑΡΝΑΝΙΑΣ,701,70,0,20,70,2021-01-07T00:00:00,220,220,0,220
ΑΝΑΤΟΛΙΚΗΣ ΑΤΤΙΚΗΣ,901,136,0,76,136,2021-01-07T00:00:00,702,702,0,702
ΑΝΔΡΟΥ,1201,0,0,0,0,2021-01-07T00:00:00,0,0,0,0
ΑΡΓΟΛΙΔΑΣ,1001,0,0,0,0,2021-01-07T00:00:00,0,0,0,0
ΑΡΚΑΔΙΑΣ,1002,70,0,70,70,2021-01-07T00:00:00,70,70,0,70
ΑΡΤΑΣ,401,50,0,35,50,2021-01-07T00:00:00,240,240,0,240
ΑΧΑΪΑΣ,702,165,0,125,165,2021-01-07T00:00:00,1421,1421,0,1421
ΒΟΙΩΤΙΑΣ,801,0,0,0,0,2021-01-07T00:00:00,0,0,0,0
ΒΟΡΕΙΟΥ ΤΟΜΕΑ ΑΘΗΝΩΝ,902,576,0,137,576,2021-01-07T00:00:00,2334,2334,0,2334
ΓΡΕΒΕΝΩΝ,301,0,0,0,0,2021-01-07T00:00:00,0,0,0,0
ΔΡΑΜΑΣ,101,0,0,0,0,2021-01-07T00:00:00,0,0,0,0
ΔΥΤΙΚΗΣ ΑΤΤΙΚΗΣ,903,60,0,60,60,2021-01-07T00:00:00,399,399,0,399
ΔΥΤΙΚΟΥ ΤΟΜΕΑ ΑΘΗΝΩΝ,904,201,0,41,201,2021-01-07T00:00:00,1046,1046,0,1046
ΕΒΡΟΥ,102,0,0,0,0,2021-01-07T00:00:00,0,0,0,0
ΕΥΒΟΙΑΣ,802,50,0,50,50,2021-01-07T00:00:00,50,50,0,50
ΕΥΡΥΤΑΝΙΑΣ,803,0,0,0,0,2021-01-07T00:00:00,0,0,0,0
ΖΑΚΥΝΘΟΥ,601,0,0,0,0,2021-01-07T00:00:00,0,0,0,0
ΗΛΕΙΑΣ,703,80,0,80,80,2021-01-07T00:00:00,80,80,0,80
ΗΜΑΘΙΑΣ,201,40,0,10,40,2021-01-07T00:00:00,199,199,0,199
ΗΡΑΚΛΕΙΟΥ,1301,120,0,0,120,2021-01-07T00:00:00,496,496,0,496
ΘΑΣΟΥ,103,0,0,0,0,2021-01-07T00:00:00,0,0,0,0
ΘΕΣΠΡΩΤΙΑΣ,402,40,0,40,40,2021-01-07T00:00:00,40,40,0,40
ΘΕΣΣΑΛΟΝΙΚΗΣ,202,900,0,350,900,2021-01-07T00:00:00,4358,4358,0,4358
ΘΗΡΑΣ,1202,0,0,0,0,2021-01-07T00:00:00,0,0,0,0
ΙΘΑΚΗΣ,602,0,0,0,0,2021-01-07T00:00:00,0,0,0,0
ΙΚΑΡΙΑΣ,1101,0,0,0,0,2021-01-07T00:00:00,0,0,0,0
ΙΩΑΝΝΙΝΩΝ,403,190,0,30,190,2021-01-07T00:00:00,1253,1253,0,1253
ΚΑΒΑΛΑΣ,104,0,0,0,0,2021-01-07T00:00:00,0,0,0,0
ΚΑΛΥΜΝΟΥ,1203,0,0,0,0,2021-01-07T00:00:00,0,0,0,0
ΚΑΡΔΙΤΣΑΣ,501,100,0,-5,100,2021-01-07T00:00:00,445,445,0,445
ΚΑΡΠΑΘΟΥ,1204,0,0,0,0,2021-01-07T00:00:00,0,0,0,0
ΚΑΣΤΟΡΙΑΣ,302,0,0,0,0,2021-01-07T00:00:00,0,0,0,0
ΚΕΑΣ-ΚΥΘΝΟΥ,1205,0,0,0,0,2021-01-07T00:00:00,0,0,0,0
ΚΕΝΤΡΙΚΟΥ ΤΟΜΕΑ ΑΘΗΝΩΝ,905,1856,0,347,1856,2021-01-07T00:00:00,8694,8694,0,8694
ΚΕΡΚΥΡΑΣ,603,0,0,0,0,2021-01-07T00:00:00,0,0,0,0
ΚΕΦΑΛΛΗΝΙΑΣ,604,0,0,0,0,2021-01-07T00:00:00,0,0,0,0
ΚΙΛΚΙΣ,203,0,0,0,0,2021-01-07T00:00:00,0,0,0,0
ΚΟΖΑΝΗΣ,303,80,0,-10,80,2021-01-07T00:00:00,398,398,0,398
ΚΟΡΙΝΘΙΑΣ,1003,20,0,-30,20,2021-01-07T00:00:00,170,170,0,170
ΚΩ,1206,0,0,0,0,2021-01-07T00:00:00,0,0,0,0
ΛΑΚΩΝΙΑΣ,1004,115,0,115,115,2021-01-07T00:00:00,115,115,0,115
ΛΑΡΙΣΑΣ,502,225,0,125,225,2021-01-07T00:00:00,1276,1276,0,1276
ΛΑΣΙΘΙΟΥ,1302,0,0,0,0,2021-01-07T00:00:00,0,0,0,0
ΛΕΣΒΟΥ,1102,0,0,0,0,2021-01-07T00:00:00,0,0,0,0
ΛΕΥΚΑΔΑΣ,605,0,0,0,0,2021-01-07T00:00:00,0,0,0,0
ΛΗΜΝΟΥ,1103,0,0,0,0,2021-01-07T00:00:00,0,0,0,0
ΜΑΓΝΗΣΙΑΣ,503,0,0,0,0,2021-01-07T00:00:00,0,0,0,0
ΜΕΣΣΗΝΙΑΣ,1005,45,0,45,45,2021-01-07T00:00:00,45,45,0,45
ΜΗΛΟΥ,1207,0,0,0,0,2021-01-07T00:00:00,0,0,0,0
ΜΥΚΟΝΟΥ,1208,0,0,0,0,2021-01-07T00:00:00,0,0,0,0
ΝΑΞΟΥ,1209,0,0,0,0,2021-01-07T00:00:00,0,0,0,0
ΝΗΣΩΝ,906,0,0,0,0,2021-01-07T00:00:00,0,0,0,0
ΝΟΤΙΟΥ ΤΟΜΕΑ ΑΘΗΝΩΝ,907,0,0,0,0,2021-01-07T00:00:00,0,0,0,0
ΞΑΝΘΗΣ,105,10,0,10,10,2021-01-07T00:00:00,10,10,0,10
ΠΑΡΟΥ,1210,0,0,0,0,2021-01-07T00:00:00,0,0,0,0
ΠΕΙΡΑΙΩΣ,908,148,0,51,148,2021-01-07T00:00:00,597,597,0,597
ΠΕΛΛΑΣ,204,89,0,-11,89,2021-01-07T00:00:00,400,400,0,400
ΠΙΕΡΙΑΣ,205,19,0,-51,19,2021-01-07T00:00:00,278,278,0,278
ΠΡΕΒΕΖΑΣ,404,64,0,64,64,2021-01-07T00:00:00,64,64,0,64
ΡΕΘΥΜΝΟΥ,1303,0,0,0,0,2021-01-07T00:00:00,0,0,0,0
ΡΟΔΟΠΗΣ,106,0,0,0,0,2021-01-07T00:00:00,0,0,0,0
ΡΟΔΟΥ,1211,0,0,0,0,2021-01-07T00:00:00,0,0,0,0
ΣΑΜΟΥ,1104,0,0,0,0,2021-01-07T00:00:00,0,0,0,0
ΣΕΡΡΩΝ,206,0,0,0,0,2021-01-07T00:00:00,0,0,0,0
ΣΠΟΡΑΔΩΝ,504,0,0,0,0,2021-01-07T00:00:00,0,0,0,0
ΣΥΡΟΥ,1212,0,0,0,0,2021-01-07T00:00:00,0,0,0,0
ΤΗΝΟΥ,1213,0,0,0,0,2021-01-07T00:00:00,0,0,0,0
ΤΡΙΚΑΛΩΝ,505,115,0,30,115,2021-01-07T00:00:00,400,400,0,400
ΦΘΙΩΤΙΔΑΣ,804,45,0,45,45,2021-01-07T00:00:00,45,45,0,45
ΦΛΩΡΙΝΑΣ,304,0,0,0,0,2021-01-07T00:00:00,0,0,0,0
ΦΩΚΙΔΑΣ,805,0,0,0,0,2021-01-07T00:00:00,0,0,0,0
ΧΑΛΚΙΔΙΚΗΣ,207,0,0,0,0,2021-01-07T00:00:00,0,0,0,0
ΧΑΝΙΩΝ,1304,150,0,-5,150,2021-01-07T00:00:00,600,600,0,600
ΧΙΟΥ,1105,0,0,0,0,2021-01-07T00:00:00,0,0,0,0
ΑΙΤΩΛΟΑΚΑΡΝΑΝΙΑΣ,701,105,0,35,105,2021-01-08T00:00:00,325,325,0,325
ΑΝΑΤΟΛΙΚΗΣ ΑΤΤΙΚΗΣ,901,5,0,-131,5,2021-01-08T00:00:00,707,707,0,707
ΑΝΔΡΟΥ,1201,0,0,0,0,2021-01-08T00:00:00,0,0,0,0
ΑΡΓΟΛΙΔΑΣ,1001,110,0,110,110,2021-01-08T00:00:00,110,110,0,110
ΑΡΚΑΔΙΑΣ,1002,184,0,114,184,2021-01-08T00:00:00,254,254,0,254
ΑΡΤΑΣ,401,90,0,40,90,2021-01-08T00:00:00,330,330,0,330
ΑΧΑΪΑΣ,702,130,0,-35,130,2021-01-08T00:00:00,1551,1551,0,1551
ΒΟΙΩΤΙΑΣ,801,125,0,125,125,2021-01-08T00:00:00,125,125,0,125
ΒΟΡΕΙΟΥ ΤΟΜΕΑ ΑΘΗΝΩΝ,902,844,0,268,844,2021-01-08T00:00:00,3178,3178,0,3178
ΓΡΕΒΕΝΩΝ,301,45,0,45,45,2021-01-08T00:00:00,45,45,0,45
ΔΡΑΜΑΣ,101,100,0,100,100,2021-01-08T00:00:00,100,100,0,100
ΔΥΤΙΚΗΣ ΑΤΤΙΚΗΣ,903,25,0,-35,25,2021-01-08T00:00:00,424,424,0,424
ΔΥΤΙΚΟΥ ΤΟΜΕΑ ΑΘΗΝΩΝ,904,409,0,208,409,2021-01-08T00:00:00,1455,1455,0,1455
ΕΒΡΟΥ,102,105,0,105,105,2021-01-08T00:00:00,105,105,0,105
ΕΥΒΟΙΑΣ,802,185,0,135,185,2021-01-08T00:00:00,235,235,0,235
ΕΥΡΥΤΑΝΙΑΣ,803,50,0,50,50,2021-01-08T00:00:00,50,50,0,50
ΖΑΚΥΝΘΟΥ,601,0,0,0,0,2021-01-08T00:00:00,0,0,0,0
ΗΛΕΙΑΣ,703,195,0,115,195,2021-01-08T00:00:00,275,275,0,275
ΗΜΑΘΙΑΣ,201,100,0,60,100,2021-01-08T00:00:00,299,299,0,299
ΗΡΑΚΛΕΙΟΥ,1301,231,0,111,231,2021-01-08T00:00:00,727,727,0,727
ΘΑΣΟΥ,103,0,0,0,0,2021-01-08T00:00:00,0,0,0,0
ΘΕΣΠΡΩΤΙΑΣ,402,85,0,45,85,2021-01-08T00:00:00,125,125,0,125
ΘΕΣΣΑΛΟΝΙΚΗΣ,202,840,0,-60,840,2021-01-08T00:00:00,5198,5198,0,5198
ΘΗΡΑΣ,1202,0,0,0,0,2021-01-08T00:00:00,0,0,0,0
ΙΘΑΚΗΣ,602,0,0,0,0,2021-01-08T00:00:00,0,0,0,0
ΙΚΑΡΙΑΣ,1101,0,0,0,0,2021-01-08T00:00:00,0,0,0,0
ΙΩΑΝΝΙΝΩΝ,403,220,0,30,220,2021-01-08T00:00:00,1473,1473,0,1473
ΚΑΒΑΛΑΣ,104,100,0,100,100,2021-01-08T00:00:00,100,100,0,100
ΚΑΛΥΜΝΟΥ,1203,0,0,0,0,2021-01-08T00:00:00,0,0,0,0
ΚΑΡΔΙΤΣΑΣ,501,99,0,-1,99,2021-01-08T00:00:00,544,544,0,544
ΚΑΡΠΑΘΟΥ,1204,0,0,0,0,2021-01-08T00:00:00,0,0,0,0
ΚΑΣΤΟΡΙΑΣ,302,60,0,60,60,2021-01-08T00:00:00,60,60,0,60
ΚΕΑΣ-ΚΥΘΝΟΥ,1205,0,0,0,0,2021-01-08T00:00:00,0,0,0,0
ΚΕΝΤΡΙΚΟΥ ΤΟΜΕΑ ΑΘΗΝΩΝ,905,1829,0,-27,1829,2021-01-08T00:00:00,10523,10523,0,10523
ΚΕΡΚΥΡΑΣ,603,0,0,0,0,2021-01-08T00:00:00,0,0,0,0
ΚΕΦΑΛΛΗΝΙΑΣ,604,0,0,0,0,2021-01-08T00:00:00,0,0,0,0
ΚΙΛΚΙΣ,203,105,0,105,105,2021-01-08T00:00:00,105,105,0,105
ΚΟΖΑΝΗΣ,303,50,0,-30,50,2021-01-08T00:00:00,448,448,0,448
ΚΟΡΙΝΘΙΑΣ,1003,55,0,35,55,2021-01-08T00:00:00,225,225,0,225
ΚΩ,1206,0,0,0,0,2021-01-08T00:00:00,0,0,0,0
ΛΑΚΩΝΙΑΣ,1004,150,0,35,150,2021-01-08T00:00:00,265,265,0,265
ΛΑΡΙΣΑΣ,502,165,0,-60,165,2021-01-08T00:00:00,1441,1441,0,1441
ΛΑΣΙΘΙΟΥ,1302,184,0,184,184,2021-01-08T00:00:00,184,184,0,184
ΛΕΣΒΟΥ,1102,0,0,0,0,2021-01-08T00:00:00,0,0,0,0
ΛΕΥΚΑΔΑΣ,605,0,0,0,0,2021-01-08T00:00:00,0,0,0,0
ΛΗΜΝΟΥ,1103,0,0,0,0,2021-01-08T00:00:00,0,0,0,0
ΜΑΓΝΗΣΙΑΣ,503,94,0,94,94,2021-01-08T00:00:00,94,94,0,94
ΜΕΣΣΗΝΙΑΣ,1005,205,0,160,205,2021-01-08T00:00:00,250,250,0,250
ΜΗΛΟΥ,1207,0,0,0,0,2021-01-08T00:00:00,0,0,0,0
ΜΥΚΟΝΟΥ,1208,0,0,0,0,2021-01-08T00:00:00,0,0,0,0
ΝΑΞΟΥ,1209,0,0,0,0,2021-01-08T00:00:00,0,0,0,0
ΝΗΣΩΝ,906,0,0,0,0,2021-01-08T00:00:00,0,0,0,0
ΝΟΤΙΟΥ ΤΟΜΕΑ ΑΘΗΝΩΝ,907,0,0,0,0,2021-01-08T00:00:00,0,0,0,0
ΞΑΝΘΗΣ,105,110,0,100,110,2021-01-08T00:00:00,120,120,0,120
ΠΑΡΟΥ,1210,0,0,0,0,2021-01-08T00:00:00,0,0,0,0
ΠΕΙΡΑΙΩΣ,908,456,0,308,456,2021-01-08T00:00:00,1053,1053,0,1053
ΠΕΛΛΑΣ,204,70,0,-19,70,2021-01-08T00:00:00,470,470,0,470
ΠΙΕΡΙΑΣ,205,30,0,11,30,2021-01-08T00:00:00,308,308,0,308
ΠΡΕΒΕΖΑΣ,404,104,0,40,104,2021-01-08T00:00:00,168,168,0,168
ΡΕΘΥΜΝΟΥ,1303,50,0,50,50,2021-01-08T00:00:00,50,50,0,50
ΡΟΔΟΠΗΣ,106,50,0,50,50,2021-01-08T00:00:00,50,50,0,50
ΡΟΔΟΥ,1211,0,0,0,0,2021-01-08T00:00:00,0,0,0,0
ΣΑΜΟΥ,1104,0,0,0,0,2021-01-08T00:00:00,0,0,0,0
ΣΕΡΡΩΝ,206,100,0,100,100,2021-01-08T00:00:00,100,100,0,100
ΣΠΟΡΑΔΩΝ,504,0,0,0,0,2021-01-08T00:00:00,0,0,0,0
ΣΥΡΟΥ,1212,0,0,0,0,2021-01-08T00:00:00,0,0,0,0
ΤΗΝΟΥ,1213,0,0,0,0,2021-01-08T00:00:00,0,0,0,0
ΤΡΙΚΑΛΩΝ,505,90,0,-25,90,2021-01-08T00:00:00,490,490,0,490
ΦΘΙΩΤΙΔΑΣ,804,140,0,95,140,2021-01-08T00:00:00,185,185,0,185
ΦΛΩΡΙΝΑΣ,304,78,0,78,78,2021-01-08T00:00:00,78,78,0,78
ΦΩΚΙΔΑΣ,805,50,0,50,50,2021-01-08T00:00:00,50,50,0,50
ΧΑΛΚΙΔΙΚΗΣ,207,50,0,50,50,2021-01-08T00:00:00,50,50,0,50
ΧΑΝΙΩΝ,1304,170,0,20,170,2021-01-08T00:00:00,770,770,0,770
ΧΙΟΥ,1105,0,0,0,0,2021-01-08T00:00:00,0,0,0,0
ΑΙΤΩΛΟΑΚΑΡΝΑΝΙΑΣ,701,80,0,-25,80,2021-01-09T00:00:00,405,405,0,405
ΑΝΑΤΟΛΙΚΗΣ ΑΤΤΙΚΗΣ,901,0,0,-5,0,2021-01-09T00:00:00,707,707,0,707
ΑΝΔΡΟΥ,1201,0,0,0,0,2021-01-09T00:00:00,0,0,0,0
ΑΡΓΟΛΙΔΑΣ,1001,90,0,-20,90,2021-01-09T00:00:00,200,200,0,200
ΑΡΚΑΔΙΑΣ,1002,86,0,-98,86,2021-01-09T00:00:00,340,340,0,340
ΑΡΤΑΣ,401,70,0,-20,70,2021-01-09T00:00:00,400,400,0,400
ΑΧΑΪΑΣ,702,100,0,-30,100,2021-01-09T00:00:00,1651,1651,0,1651
ΒΟΙΩΤΙΑΣ,801,70,0,-55,70,2021-01-09T00:00:00,195,195,0,195
ΒΟΡΕΙΟΥ ΤΟΜΕΑ ΑΘΗΝΩΝ,902,40,0,-804,40,2021-01-09T00:00:00,3218,3218,0,3218
ΓΡΕΒΕΝΩΝ,301,45,0,0,45,2021-01-09T00:00:00,90,90,0,90
ΔΡΑΜΑΣ,101,110,0,10,110,2021-01-09T00:00:00,210,210,0,210
ΔΥΤΙΚΗΣ ΑΤΤΙΚΗΣ,903,0,0,-25,0,2021-01-09T00:00:00,424,424,0,424
ΔΥΤΙΚΟΥ ΤΟΜΕΑ ΑΘΗΝΩΝ,904,344,0,-65,344,2021-01-09T00:00:00,1799,1799,0,1799
ΕΒΡΟΥ,102,128,0,23,128,2021-01-09T00:00:00,233,233,0,233
ΕΥΒΟΙΑΣ,802,120,0,-65,120,2021-01-09T00:00:00,355,355,0,355
ΕΥΡΥΤΑΝΙΑΣ,803,35,0,-15,35,2021-01-09T00:00:00,85,85,0,85
ΖΑΚΥΝΘΟΥ,601,0,0,0,0,2021-01-09T00:00:00,0,0,0,0
ΗΛΕΙΑΣ,703,105,0,-90,105,2021-01-09T00:00:00,380,380,0,380
ΗΜΑΘΙΑΣ,201,100,0,0,100,2021-01-09T00:00:00,399,399,0,399
ΗΡΑΚΛΕΙΟΥ,1301,219,0,-12,219,2021-01-09T00:00:00,946,946,0,946
ΘΑΣΟΥ,103,0,0,0,0,2021-01-09T00:00:00,0,0,0,0
ΘΕΣΠΡΩΤΙΑΣ,402,55,0,-30,55,2021-01-09T00:00:00,180,180,0,180
ΘΕΣΣΑΛΟΝΙΚΗΣ,202,490,0,-350,490,2021-01-09T00:00:00,5688,5688,0,5688
ΘΗΡΑΣ,1202,0,0,0,0,2021-01-09T00:00:00,0,0,0,0
ΙΘΑΚΗΣ,602,0,0,0,0,2021-01-09T00:00:00,0,0,0,0
ΙΚΑΡΙΑΣ,1101,0,0,0,0,2021-01-09T00:00:00,0,0,0,0
ΙΩΑΝΝΙΝΩΝ,403,135,0,-85,135,2021-01-09T00:00:00,1608,1608,0,1608
ΚΑΒΑΛΑΣ,104,120,0,20,120,2021-01-09T00:00:00,220,220,0,220
ΚΑΛΥΜΝΟΥ,1203,0,0,0,0,2021-01-09T00:00:00,0,0,0,0
ΚΑΡΔΙΤΣΑΣ,501,0,0,-99,0,2021-01-09T00:00:00,544,544,0,544
ΚΑΡΠΑΘΟΥ,1204,0,0,0,0,2021-01-09T00:00:00,0,0,0,0
ΚΑΣΤΟΡΙΑΣ,302,54,0,-6,54,2021-01-09T00:00:00,114,114,0,114
ΚΕΑΣ-ΚΥΘΝΟΥ,1205,0,0,0,0,2021-01-09T00:00:00,0,0,0,0
ΚΕΝΤΡΙΚΟΥ ΤΟΜΕΑ ΑΘΗΝΩΝ,905,869,0,-960,869,2021-01-09T00:00:00,11392,11392,0,11392
ΚΕΡΚΥΡΑΣ,603,0,0,0,0,2021-01-09T00:00:00,0,0,0,0
ΚΕΦΑΛΛΗΝΙΑΣ,604,0,0,0,0,2021-01-09T00:00:00,0,0,0,0
ΚΙΛΚΙΣ,203,50,0,-55,50,2021-01-09T00:00:00,155,155,0,155
ΚΟΖΑΝΗΣ,303,50,0,0,50,2021-01-09T00:00:00,498,498,0,498
ΚΟΡΙΝΘΙΑΣ,1003,55,0,0,55,2021-01-09T00:00:00,280,280,0,280
ΚΩ,1206,0,0,0,0,2021-01-09T00:00:00,0,0,0,0
ΛΑΚΩΝΙΑΣ,1004,119,0,-31,119,2021-01-09T00:00:00,384,384,0,384
ΛΑΡΙΣΑΣ,502,40,0,-125,40,2021-01-09T00:00:00,1481,1481,0,1481
ΛΑΣΙΘΙΟΥ,1302,95,0,-89,95,2021-01-09T00:00:00,279,279,0,279
ΛΕΣΒΟΥ,1102,0,0,0,0,2021-01-09T00:00:00,0,0,0,0
ΛΕΥΚΑΔΑΣ,605,0,0,0,0,2021-01-09T00:00:00,0,0,0,0
ΛΗΜΝΟΥ,1103,0,0,0,0,2021-01-09T00:00:00,0,0,0,0
ΜΑΓΝΗΣΙΑΣ,503,95,0,1,95,2021-01-09T00:00:00,189,189,0,189
ΜΕΣΣΗΝΙΑΣ,1005,138,0,-67,138,2021-01-09T00:00:00,388,388,0,388
ΜΗΛΟΥ,1207,0,0,0,0,2021-01-09T00:00:00,0,0,0,0
ΜΥΚΟΝΟΥ,1208,0,0,0,0,2021-01-09T00:00:00,0,0,0,0
ΝΑΞΟΥ,1209,0,0,0,0,2021-01-09T00:00:00,0,0,0,0
ΝΗΣΩΝ,906,0,0,0,0,2021-01-09T00:00:00,0,0,0,0
ΝΟΤΙΟΥ ΤΟΜΕΑ ΑΘΗΝΩΝ,907,0,0,0,0,2021-01-09T00:00:00,0,0,0,0
ΞΑΝΘΗΣ,105,110,0,0,110,2021-01-09T00:00:00,230,230,0,230
ΠΑΡΟΥ,1210,0,0,0,0,2021-01-09T00:00:00,0,0,0,0
ΠΕΙΡΑΙΩΣ,908,246,0,-210,246,2021-01-09T00:00:00,1299,1299,0,1299
ΠΕΛΛΑΣ,204,20,0,-50,20,2021-01-09T00:00:00,490,490,0,490
ΠΙΕΡΙΑΣ,205,15,0,-15,15,2021-01-09T00:00:00,323,323,0,323
ΠΡΕΒΕΖΑΣ,404,57,0,-47,57,2021-01-09T00:00:00,225,225,0,225
ΡΕΘΥΜΝΟΥ,1303,50,0,0,50,2021-01-09T00:00:00,100,100,0,100
ΡΟΔΟΠΗΣ,106,50,0,0,50,2021-01-09T00:00:00,100,100,0,100
ΡΟΔΟΥ,1211,0,0,0,0,2021-01-09T00:00:00,0,0,0,0
ΣΑΜΟΥ,1104,0,0,0,0,2021-01-09T00:00:00,0,0,0,0
ΣΕΡΡΩΝ,206,100,0,0,100,2021-01-09T00:00:00,200,200,0,200
ΣΠΟΡΑΔΩΝ,504,0,0,0,0,2021-01-09T00:00:00,0,0,0,0
ΣΥΡΟΥ,1212,0,0,0,0,2021-01-09T00:00:00,0,0,0,0
ΤΗΝΟΥ,1213,0,0,0,0,2021-01-09T00:00:00,0,0,0,0
ΤΡΙΚΑΛΩΝ,505,50,0,-40,50,2021-01-09T00:00:00,540,540,0,540
ΦΘΙΩΤΙΔΑΣ,804,100,0,-40,100,2021-01-09T00:00:00,285,285,0,285
ΦΛΩΡΙΝΑΣ,304,60,0,-18,60,2021-01-09T00:00:00,138,138,0,138
ΦΩΚΙΔΑΣ,805,40,0,-10,40,2021-01-09T00:00:00,90,90,0,90
ΧΑΛΚΙΔΙΚΗΣ,207,65,0,15,65,2021-01-09T00:00:00,115,115,0,115
ΧΑΝΙΩΝ,1304,85,0,-85,85,2021-01-09T00:00:00,855,855,0,855
ΧΙΟΥ,1105,0,0,0,0,2021-01-09T00:00:00,0,0,0,0
ΑΙΤΩΛΟΑΚΑΡΝΑΝΙΑΣ,701,90,0,10,90,2021-01-10T00:00:00,495,495,0,495
ΑΝΑΤΟΛΙΚΗΣ ΑΤΤΙΚΗΣ,901,0,0,0,0,2021-01-10T00:00:00,707,707,0,707
ΑΝΔΡΟΥ,1201,0,0,0,0,2021-01-10T00:00:00,0,0,0,0
ΑΡΓΟΛΙΔΑΣ,1001,35,0,-55,35,2021-01-10T00:00:00,235,235,0,235
ΑΡΚΑΔΙΑΣ,1002,115,0,29,115,2021-01-10T00:00:00,455,455,0,455
ΑΡΤΑΣ,401,0,0,-70,0,2021-01-10T00:00:00,400,400,0,400
ΑΧΑΪΑΣ,702,0,0,-100,0,2021-01-10T00:00:00,1651,1651,0,1651
ΒΟΙΩΤΙΑΣ,801,75,0,5,75,2021-01-10T00:00:00,270,270,0,270
ΒΟΡΕΙΟΥ ΤΟΜΕΑ ΑΘΗΝΩΝ,902,162,0,122,162,2021-01-10T00:00:00,3380,3380,0,3380
ΓΡΕΒΕΝΩΝ,301,45,0,0,45,2021-01-10T00:00:00,135,135,0,135
ΔΡΑΜΑΣ,101,100,0,-10,100,2021-01-10T00:00:00,310,310,0,310
ΔΥΤΙΚΗΣ ΑΤΤΙΚΗΣ,903,0,0,0,0,2021-01-10T00:00:00,424,424,0,424
ΔΥΤΙΚΟΥ ΤΟΜΕΑ ΑΘΗΝΩΝ,904,225,0,-119,225,2021-01-10T00:00:00,2024,2024,0,2024
ΕΒΡΟΥ,102,154,0,26,154,2021-01-10T00:00:00,387,387,0,387
ΕΥΒΟΙΑΣ,802,95,0,-25,95,2021-01-10T00:00:00,450,450,0,450
ΕΥΡΥΤΑΝΙΑΣ,803,15,0,-20,15,2021-01-10T00:00:00,100,100,0,100
ΖΑΚΥΝΘΟΥ,601,0,0,0,0,2021-01-10T00:00:00,0,0,0,0
ΗΛΕΙΑΣ,703,80,0,-25,80,2021-01-10T00:00:00,460,460,0,460
ΗΜΑΘΙΑΣ,201,100,0,0,100,2021-01-10T00:00:00,499,499,0,499
ΗΡΑΚΛΕΙΟΥ,1301,210,0,-9,210,2021-01-10T00:00:00,1156,1156,0,1156
ΘΑΣΟΥ,103,0,0,0,0,2021-01-10T00:00:00,0,0,0,0
ΘΕΣΠΡΩΤΙΑΣ,402,45,0,-10,45,2021-01-10T00:00:00,225,225,0,225
ΘΕΣΣΑΛΟΝΙΚΗΣ,202,310,0,-180,310,2021-01-10T00:00:00,5998,5998,0,5998
ΘΗΡΑΣ,1202,0,0,0,0,2021-01-10T00:00:00,0,0,0,0
ΙΘΑΚΗΣ,602,0,0,0,0,2021-01-10T00:00:00,0,0,0,0
ΙΚΑΡΙΑΣ,1101,0,0,0,0,2021-01-10T00:00:00,0,0,0,0
ΙΩΑΝΝΙΝΩΝ,403,135,0,0,135,2021-01-10T00:00:00,1743,1743,0,1743
ΚΑΒΑΛΑΣ,104,120,0,0,120,2021-01-10T00:00:00,340,340,0,340
ΚΑΛΥΜΝΟΥ,1203,0,0,0,0,2021-01-10T00:00:00,0,0,0,0
ΚΑΡΔΙΤΣΑΣ,501,0,0,0,0,2021-01-10T00:00:00,544,544,0,544
ΚΑΡΠΑΘΟΥ,1204,0,0,0,0,2021-01-10T00:00:00,0,0,0,0
ΚΑΣΤΟΡΙΑΣ,302,40,0,-14,40,2021-01-10T00:00:00,154,154,0,154
ΚΕΑΣ-ΚΥΘΝΟΥ,1205,0,0,0,0,2021-01-10T00:00:00,0,0,0,0
ΚΕΝΤΡΙΚΟΥ ΤΟΜΕΑ ΑΘΗΝΩΝ,905,645,0,-224,645,2021-01-10T00:00:00,12037,12037,0,12037
ΚΕΡΚΥΡΑΣ,603,0,0,0,0,2021-01-10T00:00:00,0,0,0,0
ΚΕΦΑΛΛΗΝΙΑΣ,604,0,0,0,0,2021-01-10T00:00:00,0,0,0,0
ΚΙΛΚΙΣ,203,50,0,0,50,2021-01-10T00:00:00,205,205,0,205
ΚΟΖΑΝΗΣ,303,50,0,0,50,2021-01-10T00:00:00,548,548,0,548
ΚΟΡΙΝΘΙΑΣ,1003,0,0,-55,0,2021-01-10T00:00:00,280,280,0,280
ΚΩ,1206,0,0,0,0,2021-01-10T00:00:00,0,0,0,0
ΛΑΚΩΝΙΑΣ,1004,0,0,-119,0,2021-01-10T00:00:00,384,384,0,384
ΛΑΡΙΣΑΣ,502,50,0,10,50,2021-01-10T00:00:00,1531,1531,0,1531
ΛΑΣΙΘΙΟΥ,1302,85,0,-10,85,2021-01-10T00:00:00,364,364,0,364
ΛΕΣΒΟΥ,1102,0,0,0,0,2021-01-10T00:00:00,0,0,0,0
ΛΕΥΚΑΔΑΣ,605,0,0,0,0,2021-01-10T00:00:00,0,0,0,0
ΛΗΜΝΟΥ,1103,0,0,0,0,2021-01-10T00:00:00,0,0,0,0
ΜΑΓΝΗΣΙΑΣ,503,80,0,-15,80,2021-01-10T00:00:00,269,269,0,269
ΜΕΣΣΗΝΙΑΣ,1005,147,0,9,147,2021-01-10T00:00:00,535,535,0,535
ΜΗΛΟΥ,1207,0,0,0,0,2021-01-10T00:00:00,0,0,0,0
ΜΥΚΟΝΟΥ,1208,0,0,0,0,2021-01-10T00:00:00,0,0,0,0
ΝΑΞΟΥ,1209,0,0,0,0,2021-01-10T00:00:00,0,0,0,0
ΝΗΣΩΝ,906,0,0,0,0,2021-01-10T00:00:00,0,0,0,0
ΝΟΤΙΟΥ ΤΟΜΕΑ ΑΘΗΝΩΝ,907,0,0,0,0,2021-01-10T00:00:00,0,0,0,0
ΞΑΝΘΗΣ,105,105,0,-5,105,2021-01-10T00:00:00,335,335,0,335
ΠΑΡΟΥ,1210,0,0,0,0,2021-01-10T00:00:00,0,0,0,0
ΠΕΙΡΑΙΩΣ,908,235,0,-11,235,2021-01-10T00:00:00,1534,1534,0,1534
ΠΕΛΛΑΣ,204,20,0,0,20,2021-01-10T00:00:00,510,510,0,510
ΠΙΕΡΙΑΣ,205,5,0,-10,5,2021-01-10T00:00:00,328,328,0,328
ΠΡΕΒΕΖΑΣ,404,80,0,23,80,2021-01-10T00:00:00,305,305,0,305
ΡΕΘΥΜΝΟΥ,1303,50,0,0,50,2021-01-10T00:00:00,150,150,0,150
ΡΟΔΟΠΗΣ,106,50,0,0,50,2021-01-10T00:00:00,150,150,0,150
ΡΟΔΟΥ,1211,0,0,0,0,2021-01-10T00:00:00,0,0,0,0
ΣΑΜΟΥ,1104,0,0,0,0,2021-01-10T00:00:00,0,0,0,0
ΣΕΡΡΩΝ,206,100,0,0,100,2021-01-10T00:00:00,300,300,0,300
ΣΠΟΡΑΔΩΝ,504,0,0,0,0,2021-01-10T00:00:00,0,0,0,0
ΣΥΡΟΥ,1212,0,0,0,0,2021-01-10T00:00:00,0,0,0,0
ΤΗΝΟΥ,1213,0,0,0,0,2021-01-10T00:00:00,0,0,0,0
ΤΡΙΚΑΛΩΝ,505,55,0,5,55,2021-01-10T00:00:00,595,595,0,595
ΦΘΙΩΤΙΔΑΣ,804,100,0,0,100,2021-01-10T00:00:00,385,385,0,385
ΦΛΩΡΙΝΑΣ,304,60,0,0,60,2021-01-10T00:00:00,198,198,0,198
ΦΩΚΙΔΑΣ,805,10,0,-30,10,2021-01-10T00:00:00,100,100,0,100
ΧΑΛΚΙΔΙΚΗΣ,207,55,0,-10,55,2021-01-10T00:00:00,170,170,0,170
ΧΑΝΙΩΝ,1304,35,0,-50,35,2021-01-10T00:00:00,890,890,0,890
ΧΙΟΥ,1105,0,0,0,0,2021-01-10T00:00:00,0,0,0,0
ΑΙΤΩΛΟΑΚΑΡΝΑΝΙΑΣ,701,140,0,50,140,2021-01-11T00:00:00,635,635,0,635
ΑΝΑΤΟΛΙΚΗΣ ΑΤΤΙΚΗΣ,901,0,0,0,0,2021-01-11T00:00:00,707,707,0,707
ΑΝΔΡΟΥ,1201,0,0,0,0,2021-01-11T00:00:00,0,0,0,0
ΑΡΓΟΛΙΔΑΣ,1001,25,0,-10,25,2021-01-11T00:00:00,260,260,0,260
ΑΡΚΑΔΙΑΣ,1002,30,0,-85,30,2021-01-11T00:00:00,485,485,0,485
ΑΡΤΑΣ,401,51,0,51,51,2021-01-11T00:00:00,451,451,0,451
ΑΧΑΪΑΣ,702,10,0,10,10,2021-01-11T00:00:00,1661,1661,0,1661
ΒΟΙΩΤΙΑΣ,801,80,0,5,80,2021-01-11T00:00:00,350,350,0,350
ΒΟΡΕΙΟΥ ΤΟΜΕΑ ΑΘΗΝΩΝ,902,910,0,748,910,2021-01-11T00:00:00,4290,4290,0,4290
ΓΡΕΒΕΝΩΝ,301,45,0,0,45,2021-01-11T00:00:00,180,180,0,180
ΔΡΑΜΑΣ,101,65,0,-35,65,2021-01-11T00:00:00,375,375,0,375
ΔΥΤΙΚΗΣ ΑΤΤΙΚΗΣ,903,23,0,23,23,2021-01-11T00:00:00,447,447,0,447
ΔΥΤΙΚΟΥ ΤΟΜΕΑ ΑΘΗΝΩΝ,904,264,0,39,264,2021-01-11T00:00:00,2288,2288,0,2288
ΕΒΡΟΥ,102,143,0,-11,143,2021-01-11T00:00:00,530,530,0,530
ΕΥΒΟΙΑΣ,802,65,0,-30,65,2021-01-11T00:00:00,515,515,0,515
ΕΥΡΥΤΑΝΙΑΣ,803,20,0,5,20,2021-01-11T00:00:00,120,120,0,120
ΖΑΚΥΝΘΟΥ,601,0,0,0,0,2021-01-11T00:00:00,0,0,0,0
ΗΛΕΙΑΣ,703,55,0,-25,55,2021-01-11T00:00:00,515,515,0,515
ΗΜΑΘΙΑΣ,201,60,0,-40,60,2021-01-11T00:00:00,559,559,0,559
ΗΡΑΚΛΕΙΟΥ,1301,223,0,13,223,2021-01-11T00:00:00,1379,1379,0,1379
ΘΑΣΟΥ,103,0,0,0,0,2021-01-11T00:00:00,0,0,0,0
ΘΕΣΠΡΩΤΙΑΣ,402,0,0,-45,0,2021-01-11T00:00:00,225,225,0,225
ΘΕΣΣΑΛΟΝΙΚΗΣ,202,581,0,271,581,2021-01-11T00:00:00,6579,6579,0,6579
ΘΗΡΑΣ,1202,5,0,5,5,2021-01-11T00:00:00,5,5,0,5
ΙΘΑΚΗΣ,602,0,0,0,0,2021-01-11T00:00:00,0,0,0,0
ΙΚΑΡΙΑΣ,1101,0,0,0,0,2021-01-11T00:00:00,0,0,0,0
ΙΩΑΝΝΙΝΩΝ,403,180,0,45,180,2021-01-11T00:00:00,1923,1923,0,1923
ΚΑΒΑΛΑΣ,104,120,0,0,120,2021-01-11T00:00:00,460,460,0,460
ΚΑΛΥΜΝΟΥ,1203,0,0,0,0,2021-01-11T00:00:00,0,0,0,0
ΚΑΡΔΙΤΣΑΣ,501,0,0,0,0,2021-01-11T00:00:00,544,544,0,544
ΚΑΡΠΑΘΟΥ,1204,0,0,0,0,2021-01-11T00:00:00,0,0,0,0
ΚΑΣΤΟΡΙΑΣ,302,45,0,5,45,2021-01-11T00:00:00,199,199,0,199
ΚΕΑΣ-ΚΥΘΝΟΥ,1205,0,0,0,0,2021-01-11T00:00:00,0,0,0,0
ΚΕΝΤΡΙΚΟΥ ΤΟΜΕΑ ΑΘΗΝΩΝ,905,1019,0,374,1019,2021-01-11T00:00:00,13056,13056,0,13056
ΚΕΡΚΥΡΑΣ,603,65,0,65,65,2021-01-11T00:00:00,65,65,0,65
ΚΕΦΑΛΛΗΝΙΑΣ,604,20,0,20,20,2021-01-11T00:00:00,20,20,0,20
ΚΙΛΚΙΣ,203,60,0,10,60,2021-01-11T00:00:00,265,265,0,265
ΚΟΖΑΝΗΣ,303,50,0,0,50,2021-01-11T00:00:00,598,598,0,598
ΚΟΡΙΝΘΙΑΣ,1003,0,0,0,0,2021-01-11T00:00:00,280,280,0,280
ΚΩ,1206,0,0,0,0,2021-01-11T00:00:00,0,0,0,0
ΛΑΚΩΝΙΑΣ,1004,15,0,15,15,2021-01-11T00:00:00,399,399,0,399
ΛΑΡΙΣΑΣ,502,35,0,-15,35,2021-01-11T00:00:00,1566,1566,0,1566
ΛΑΣΙΘΙΟΥ,1302,54,0,-31,54,2021-01-11T00:00:00,418,418,0,418
ΛΕΣΒΟΥ,1102,0,0,0,0,2021-01-11T00:00:00,0,0,0,0
ΛΕΥΚΑΔΑΣ,605,30,0,30,30,2021-01-11T00:00:00,30,30,0,30
ΛΗΜΝΟΥ,1103,0,0,0,0,2021-01-11T00:00:00,0,0,0,0
ΜΑΓΝΗΣΙΑΣ,503,120,0,40,120,2021-01-11T00:00:00,389,389,0,389
ΜΕΣΣΗΝΙΑΣ,1005,25,0,-122,25,2021-01-11T00:00:00,560,560,0,560
ΜΗΛΟΥ,1207,0,0,0,0,2021-01-11T00:00:00,0,0,0,0
ΜΥΚΟΝΟΥ,1208,0,0,0,0,2021-01-11T00:00:00,0,0,0,0
ΝΑΞΟΥ,1209,0,0,0,0,2021-01-11T00:00:00,0,0,0,0
ΝΗΣΩΝ,906,0,0,0,0,2021-01-11T00:00:00,0,0,0,0
ΝΟΤΙΟΥ ΤΟΜΕΑ ΑΘΗΝΩΝ,907,25,0,25,25,2021-01-11T00:00:00,25,25,0,25
ΞΑΝΘΗΣ,105,120,0,15,120,2021-01-11T00:00:00,455,455,0,455
ΠΑΡΟΥ,1210,0,0,0,0,2021-01-11T00:00:00,0,0,0,0
ΠΕΙΡΑΙΩΣ,908,55,0,-180,55,2021-01-11T00:00:00,1589,1589,0,1589
ΠΕΛΛΑΣ,204,15,0,-5,15,2021-01-11T00:00:00,525,525,0,525
ΠΙΕΡΙΑΣ,205,25,0,20,25,2021-01-11T00:00:00,353,353,0,353
ΠΡΕΒΕΖΑΣ,404,15,0,-65,15,2021-01-11T00:00:00,320,320,0,320
ΡΕΘΥΜΝΟΥ,1303,70,0,20,70,2021-01-11T00:00:00,220,220,0,220
ΡΟΔΟΠΗΣ,106,50,0,0,50,2021-01-11T00:00:00,200,200,0,200
ΡΟΔΟΥ,1211,0,0,0,0,2021-01-11T00:00:00,0,0,0,0
ΣΑΜΟΥ,1104,0,0,0,0,2021-01-11T00:00:00,0,0,0,0
ΣΕΡΡΩΝ,206,100,0,0,100,2021-01-11T00:00:00,400,400,0,400
ΣΠΟΡΑΔΩΝ,504,0,0,0,0,2021-01-11T00:00:00,0,0,0,0
ΣΥΡΟΥ,1212,0,0,0,0,2021-01-11T00:00:00,0,0,0,0
ΤΗΝΟΥ,1213,0,0,0,0,2021-01-11T00:00:00,0,0,0,0
ΤΡΙΚΑΛΩΝ,505,25,0,-30,25,2021-01-11T00:00:00,620,620,0,620
ΦΘΙΩΤΙΔΑΣ,804,105,0,5,105,2021-01-11T00:00:00,490,490,0,490
ΦΛΩΡΙΝΑΣ,304,43,0,-17,43,2021-01-11T00:00:00,241,241,0,241
ΦΩΚΙΔΑΣ,805,5,0,-5,5,2021-01-11T00:00:00,105,105,0,105
ΧΑΛΚΙΔΙΚΗΣ,207,75,0,20,75,2021-01-11T00:00:00,245,245,0,245
ΧΑΝΙΩΝ,1304,39,0,4,39,2021-01-11T00:00:00,929,929,0,929
ΧΙΟΥ,1105,0,0,0,0,2021-01-11T00:00:00,0,0,0,0
ΑΙΤΩΛΟΑΚΑΡΝΑΝΙΑΣ,701,55,0,-85,55,2021-01-12T00:00:00,690,690,0,690
ΑΝΑΤΟΛΙΚΗΣ ΑΤΤΙΚΗΣ,901,0,0,0,0,2021-01-12T00:00:00,707,707,0,707
ΑΝΔΡΟΥ,1201,0,0,0,0,2021-01-12T00:00:00,0,0,0,0
ΑΡΓΟΛΙΔΑΣ,1001,0,0,-25,0,2021-01-12T00:00:00,260,260,0,260
ΑΡΚΑΔΙΑΣ,1002,0,0,-30,0,2021-01-12T00:00:00,485,485,0,485
ΑΡΤΑΣ,401,84,0,33,84,2021-01-12T00:00:00,535,535,0,535
ΑΧΑΪΑΣ,702,105,0,95,105,2021-01-12T00:00:00,1766,1766,0,1766
ΒΟΙΩΤΙΑΣ,801,10,0,-70,10,2021-01-12T00:00:00,360,360,0,360
ΒΟΡΕΙΟΥ ΤΟΜΕΑ ΑΘΗΝΩΝ,902,1248,0,338,1248,2021-01-12T00:00:00,5538,5538,0,5538
ΓΡΕΒΕΝΩΝ,301,15,0,-30,15,2021-01-12T00:00:00,195,195,0,195
ΔΡΑΜΑΣ,101,0,0,-65,0,2021-01-12T00:00:00,375,375,0,375
ΔΥΤΙΚΗΣ ΑΤΤΙΚΗΣ,903,25,0,2,25,2021-01-12T00:00:00,472,472,0,472
ΔΥΤΙΚΟΥ ΤΟΜΕΑ ΑΘΗΝΩΝ,904,25,0,-239,25,2021-01-12T00:00:00,2313,2313,0,2313
ΕΒΡΟΥ,102,164,0,21,164,2021-01-12T00:00:00,694,694,0,694
ΕΥΒΟΙΑΣ,802,60,0,-5,60,2021-01-12T00:00:00,575,575,0,575
ΕΥΡΥΤΑΝΙΑΣ,803,25,0,5,25,2021-01-12T00:00:00,145,145,0,145
ΖΑΚΥΝΘΟΥ,601,50,0,50,50,2021-01-12T00:00:00,50,50,0,50
ΗΛΕΙΑΣ,703,0,0,-55,0,2021-01-12T00:00:00,515,515,0,515
ΗΜΑΘΙΑΣ,201,15,0,-45,15,2021-01-12T00:00:00,574,574,0,574
ΗΡΑΚΛΕΙΟΥ,1301,229,0,6,229,2021-01-12T00:00:00,1608,1608,0,1608
ΘΑΣΟΥ,103,0,0,0,0,2021-01-12T00:00:00,0,0,0,0
ΘΕΣΠΡΩΤΙΑΣ,402,0,0,0,0,2021-01-12T00:00:00,225,225,0,225
ΘΕΣΣΑΛΟΝΙΚΗΣ,202,735,0,154,735,2021-01-12T00:00:00,7314,7314,0,7314
ΘΗΡΑΣ,1202,15,0,10,15,2021-01-12T00:00:00,20,20,0,20
ΙΘΑΚΗΣ,602,0,0,0,0,2021-01-12T00:00:00,0,0,0,0
ΙΚΑΡΙΑΣ,1101,25,0,25,25,2021-01-12T00:00:00,25,25,0,25
ΙΩΑΝΝΙΝΩΝ,403,180,0,0,180,2021-01-12T00:00:00,2103,2103,0,2103
ΚΑΒΑΛΑΣ,104,65,0,-55,65,2021-01-12T00:00:00,525,525,0,525
ΚΑΛΥΜΝΟΥ,1203,10,0,10,10,2021-01-12T00:00:00,10,10,0,10
ΚΑΡΔΙΤΣΑΣ,501,0,0,0,0,2021-01-12T00:00:00,544,544,0,544
ΚΑΡΠΑΘΟΥ,1204,10,0,10,10,2021-01-12T00:00:00,10,10,0,10
ΚΑΣΤΟΡΙΑΣ,302,40,0,-5,40,2021-01-12T00:00:00,239,239,0,239
ΚΕΑΣ-ΚΥΘΝΟΥ,1205,0,0,0,0,2021-01-12T00:00:00,0,0,0,0
ΚΕΝΤΡΙΚΟΥ ΤΟΜΕΑ ΑΘΗΝΩΝ,905,1437,0,418,1437,2021-01-12T00:00:00,14493,14493,0,14493
ΚΕΡΚΥΡΑΣ,603,100,0,35,100,2021-01-12T00:00:00,165,165,0,165
ΚΕΦΑΛΛΗΝΙΑΣ,604,90,0,70,90,2021-01-12T00:00:00,110,110,0,110
ΚΙΛΚΙΣ,203,40,0,-20,40,2021-01-12T00:00:00,305,305,0,305
ΚΟΖΑΝΗΣ,303,35,0,-15,35,2021-01-12T00:00:00,633,633,0,633
ΚΟΡΙΝΘΙΑΣ,1003,10,0,10,10,2021-01-12T00:00:00,290,290,0,290
ΚΩ,1206,0,0,0,0,2021-01-12T00:00:00,0,0,0,0
ΛΑΚΩΝΙΑΣ,1004,0,0,-15,0,2021-01-12T00:00:00,399,399,0,399
ΛΑΡΙΣΑΣ,502,115,0,80,115,2021-01-12T00:00:00,1681,1681,0,1681
ΛΑΣΙΘΙΟΥ,1302,50,0,-4,50,2021-01-12T00:00:00,468,468,0,468
ΛΕΣΒΟΥ,1102,70,0,70,70,2021-01-12T00:00:00,70,70,0,70
ΛΕΥΚΑΔΑΣ,605,50,0,20,50,2021-01-12T00:00:00,80,80,0,80
ΛΗΜΝΟΥ,1103,43,0,43,43,2021-01-12T00:00:00,43,43,0,43
ΜΑΓΝΗΣΙΑΣ,503,135,0,15,135,2021-01-12T00:00:00,524,524,0,524
ΜΕΣΣΗΝΙΑΣ,1005,0,0,-25,0,2021-01-12T00:00:00,560,560,0,560
ΜΗΛΟΥ,1207,0,0,0,0,2021-01-12T00:00:00,0,0,0,0
ΜΥΚΟΝΟΥ,1208,0,0,0,0,2021-01-12T00:00:00,0,0,0,0
ΝΑΞΟΥ,1209,35,0,35,35,2021-01-12T00:00:00,35,35,0,35
ΝΗΣΩΝ,906,25,0,25,25,2021-01-12T00:00:00,25,25,0,25
ΝΟΤΙΟΥ ΤΟΜΕΑ ΑΘΗΝΩΝ,907,89,0,64,89,2021-01-12T00:00:00,114,114,0,114
ΞΑΝΘΗΣ,105,30,0,-90,30,2021-01-12T00:00:00,485,485,0,485
ΠΑΡΟΥ,1210,0,0,0,0,2021-01-12T00:00:00,0,0,0,0
ΠΕΙΡΑΙΩΣ,908,241,0,186,241,2021-01-12T00:00:00,1830,1830,0,1830
ΠΕΛΛΑΣ,204,0,0,-15,0,2021-01-12T00:00:00,525,525,0,525
ΠΙΕΡΙΑΣ,205,20,0,-5,20,2021-01-12T00:00:00,373,373,0,373
ΠΡΕΒΕΖΑΣ,404,0,0,-15,0,2021-01-12T00:00:00,320,320,0,320
ΡΕΘΥΜΝΟΥ,1303,80,0,10,80,2021-01-12T00:00:00,300,300,0,300
ΡΟΔΟΠΗΣ,106,60,0,10,60,2021-01-12T00:00:00,260,260,0,260
ΡΟΔΟΥ,1211,110,0,110,110,2021-01-12T00:00:00,110,110,0,110
ΣΑΜΟΥ,1104,60,0,60,60,2021-01-12T00:00:00,60,60,0,60
ΣΕΡΡΩΝ,206,110,0,10,110,2021-01-12T00:00:00,510,510,0,510
ΣΠΟΡΑΔΩΝ,504,0,0,0,0,2021-01-12T00:00:00,0,0,0,0
ΣΥΡΟΥ,1212,50,0,50,50,2021-01-12T00:00:00,50,50,0,50
ΤΗΝΟΥ,1213,0,0,0,0,2021-01-12T00:00:00,0,0,0,0
ΤΡΙΚΑΛΩΝ,505,0,0,-25,0,2021-01-12T00:00:00,620,620,0,620
ΦΘΙΩΤΙΔΑΣ,804,85,0,-20,85,2021-01-12T00:00:00,575,575,0,575
ΦΛΩΡΙΝΑΣ,304,0,0,-43,0,2021-01-12T00:00:00,241,241,0,241
ΦΩΚΙΔΑΣ,805,0,0,-5,0,2021-01-12T00:00:00,105,105,0,105
ΧΑΛΚΙΔΙΚΗΣ,207,0,0,-75,0,2021-01-12T00:00:00,245,245,0,245
ΧΑΝΙΩΝ,1304,0,0,-39,0,2021-01-12T00:00:00,929,929,0,929
ΧΙΟΥ,1105,70,0,70,70,2021-01-12T00:00:00,70,70,0,70
ΑΙΤΩΛΟΑΚΑΡΝΑΝΙΑΣ,701,49,0,-6,49,2021-01-13T00:00:00,739,739,0,739
ΑΝΑΤΟΛΙΚΗΣ ΑΤΤΙΚΗΣ,901,0,0,0,0,2021-01-13T00:00:00,707,707,0,707
ΑΝΔΡΟΥ,1201,0,0,0,0,2021-01-13T00:00:00,0,0,0,0
ΑΡΓΟΛΙΔΑΣ,1001,0,0,0,0,2021-01-13T00:00:00,260,260,0,260
ΑΡΚΑΔΙΑΣ,1002,10,0,10,10,2021-01-13T00:00:00,495,495,0,495
ΑΡΤΑΣ,401,30,0,-54,30,2021-01-13T00:00:00,565,565,0,565
ΑΧΑΪΑΣ,702,189,0,84,189,2021-01-13T00:00:00,1955,1955,0,1955
ΒΟΙΩΤΙΑΣ,801,0,0,-10,0,2021-01-13T00:00:00,360,360,0,360
ΒΟΡΕΙΟΥ ΤΟΜΕΑ ΑΘΗΝΩΝ,902,2468,0,1220,2468,2021-01-13T00:00:00,8006,8006,0,8006
ΓΡΕΒΕΝΩΝ,301,0,0,-15,0,2021-01-13T00:00:00,195,195,0,195
ΔΡΑΜΑΣ,101,0,0,0,0,2021-01-13T00:00:00,375,375,0,375
ΔΥΤΙΚΗΣ ΑΤΤΙΚΗΣ,903,35,0,10,35,2021-01-13T00:00:00,507,507,0,507
ΔΥΤΙΚΟΥ ΤΟΜΕΑ ΑΘΗΝΩΝ,904,90,0,65,90,2021-01-13T00:00:00,2403,2403,0,2403
ΕΒΡΟΥ,102,141,0,-23,141,2021-01-13T00:00:00,835,835,0,835
ΕΥΒΟΙΑΣ,802,0,0,-60,0,2021-01-13T00:00:00,575,575,0,575
ΕΥΡΥΤΑΝΙΑΣ,803,0,0,-25,0,2021-01-13T00:00:00,145,145,0,145
ΖΑΚΥΝΘΟΥ,601,50,0,0,50,2021-01-13T00:00:00,100,100,0,100
ΗΛΕΙΑΣ,703,0,0,0,0,2021-01-13T00:00:00,515,515,0,515
ΗΜΑΘΙΑΣ,201,30,0,15,30,2021-01-13T00:00:00,604,604,0,604
ΗΡΑΚΛΕΙΟΥ,1301,214,0,-15,214,2021-01-13T00:00:00,1822,1822,0,1822
ΘΑΣΟΥ,103,0,0,0,0,2021-01-13T00:00:00,0,0,0,0
ΘΕΣΠΡΩΤΙΑΣ,402,0,0,0,0,2021-01-13T00:00:00,225,225,0,225
ΘΕΣΣΑΛΟΝΙΚΗΣ,202,1209,0,474,1209,2021-01-13T00:00:00,8523,8523,0,8523
ΘΗΡΑΣ,1202,0,0,-15,0,2021-01-13T00:00:00,20,20,0,20
ΙΘΑΚΗΣ,602,0,0,0,0,2021-01-13T00:00:00,0,0,0,0
ΙΚΑΡΙΑΣ,1101,5,0,-20,5,2021-01-13T00:00:00,30,30,0,30
ΙΩΑΝΝΙΝΩΝ,403,100,0,-80,100,2021-01-13T00:00:00,2203,2203,0,2203
ΚΑΒΑΛΑΣ,104,55,0,-10,55,2021-01-13T00:00:00,580,580,0,580
ΚΑΛΥΜΝΟΥ,1203,88,0,78,88,2021-01-13T00:00:00,98,98,0,98
ΚΑΡΔΙΤΣΑΣ,501,0,0,0,0,2021-01-13T00:00:00,544,544,0,544
ΚΑΡΠΑΘΟΥ,1204,5,0,-5,5,2021-01-13T00:00:00,15,15,0,15
ΚΑΣΤΟΡΙΑΣ,302,37,0,-3,37,2021-01-13T00:00:00,276,276,0,276
ΚΕΑΣ-ΚΥΘΝΟΥ,1205,0,0,0,0,2021-01-13T00:00:00,0,0,0,0
ΚΕΝΤΡΙΚΟΥ ΤΟΜΕΑ ΑΘΗΝΩΝ,905,1580,0,143,1580,2021-01-13T00:00:00,16073,16073,0,16073
ΚΕΡΚΥΡΑΣ,603,35,0,-65,35,2021-01-13T00:00:00,200,200,0,200
ΚΕΦΑΛΛΗΝΙΑΣ,604,65,0,-25,65,2021-01-13T00:00:00,175,175,0,175
ΚΙΛΚΙΣ,203,0,0,-40,0,2021-01-13T00:00:00,305,305,0,305
ΚΟΖΑΝΗΣ,303,40,0,5,40,2021-01-13T00:00:00,673,673,0,673
ΚΟΡΙΝΘΙΑΣ,1003,10,0,0,10,2021-01-13T00:00:00,300,300,0,300
ΚΩ,1206,45,0,45,45,2021-01-13T00:00:00,45,45,0,45
ΛΑΚΩΝΙΑΣ,1004,0,0,0,0,2021-01-13T00:00:00,399,399,0,399
ΛΑΡΙΣΑΣ,502,30,0,-85,30,2021-01-13T00:00:00,1711,1711,0,1711
ΛΑΣΙΘΙΟΥ,1302,41,0,-9,41,2021-01-13T00:00:00,509,509,0,509
ΛΕΣΒΟΥ,1102,85,0,15,85,2021-01-13T00:00:00,155,155,0,155
ΛΕΥΚΑΔΑΣ,605,15,0,-35,15,2021-01-13T00:00:00,95,95,0,95
ΛΗΜΝΟΥ,1103,64,0,21,64,2021-01-13T00:00:00,107,107,0,107
ΜΑΓΝΗΣΙΑΣ,503,59,0,-76,59,2021-01-13T00:00:00,583,583,0,583
ΜΕΣΣΗΝΙΑΣ,1005,0,0,0,0,2021-01-13T00:00:00,560,560,0,560
ΜΗΛΟΥ,1207,0,0,0,0,2021-01-13T00:00:00,0,0,0,0
ΜΥΚΟΝΟΥ,1208,0,0,0,0,2021-01-13T00:00:00,0,0,0,0
ΝΑΞΟΥ,1209,0,0,-35,0,2021-01-13T00:00:00,35,35,0,35
ΝΗΣΩΝ,906,0,0,-25,0,2021-01-13T00:00:00,25,25,0,25
ΝΟΤΙΟΥ ΤΟΜΕΑ ΑΘΗΝΩΝ,907,431,0,342,431,2021-01-13T00:00:00,545,545,0,545
ΞΑΝΘΗΣ,105,15,0,-15,15,2021-01-13T00:00:00,500,500,0,500
ΠΑΡΟΥ,1210,0,0,0,0,2021-01-13T00:00:00,0,0,0,0
ΠΕΙΡΑΙΩΣ,908,602,0,361,602,2021-01-13T00:00:00,2432,2432,0,2432
ΠΕΛΛΑΣ,204,0,0,0,0,2021-01-13T00:00:00,525,525,0,525
ΠΙΕΡΙΑΣ,205,10,0,-10,10,2021-01-13T00:00:00,383,383,0,383
ΠΡΕΒΕΖΑΣ,404,0,0,0,0,2021-01-13T00:00:00,320,320,0,320
ΡΕΘΥΜΝΟΥ,1303,65,0,-15,65,2021-01-13T00:00:00,365,365,0,365
ΡΟΔΟΠΗΣ,106,35,0,-25,35,2021-01-13T00:00:00,295,295,0,295
ΡΟΔΟΥ,1211,115,0,5,115,2021-01-13T00:00:00,225,225,0,225
ΣΑΜΟΥ,1104,50,0,-10,50,2021-01-13T00:00:00,110,110,0,110
ΣΕΡΡΩΝ,206,90,0,-20,90,2021-01-13T00:00:00,600,600,0,600
ΣΠΟΡΑΔΩΝ,504,0,0,0,0,2021-01-13T00:00:00,0,0,0,0
ΣΥΡΟΥ,1212,50,0,0,50,2021-01-13T00:00:00,100,100,0,100
ΤΗΝΟΥ,1213,0,0,0,0,2021-01-13T00:00:00,0,0,0,0
ΤΡΙΚΑΛΩΝ,505,15,0,15,15,2021-01-13T00:00:00,635,635,0,635
ΦΘΙΩΤΙΔΑΣ,804,40,0,-45,40,2021-01-13T00:00:00,615,615,0,615
ΦΛΩΡΙΝΑΣ,304,0,0,0,0,2021-01-13T00:00:00,241,241,0,241
ΦΩΚΙΔΑΣ,805,0,0,0,0,2021-01-13T00:00:00,105,105,0,105
ΧΑΛΚΙΔΙΚΗΣ,207,0,0,0,0,2021-01-13T00:00:00,245,245,0,245
ΧΑΝΙΩΝ,1304,0,0,0,0,2021-01-13T00:00:00,929,929,0,929
ΧΙΟΥ,1105,65,0,-5,65,2021-01-13T00:00:00,135,135,0,135
ΑΙΤΩΛΟΑΚΑΡΝΑΝΙΑΣ,701,54,0,5,54,2021-01-14T00:00:00,793,793,0,793
ΑΝΑΤΟΛΙΚΗΣ ΑΤΤΙΚΗΣ,901,0,0,0,0,2021-01-14T00:00:00,707,707,0,707
ΑΝΔΡΟΥ,1201,0,0,0,0,2021-01-14T00:00:00,0,0,0,0
ΑΡΓΟΛΙΔΑΣ,1001,0,0,0,0,2021-01-14T00:00:00,260,260,0,260
ΑΡΚΑΔΙΑΣ,1002,0,0,-10,0,2021-01-14T00:00:00,495,495,0,495
ΑΡΤΑΣ,401,0,0,-30,0,2021-01-14T00:00:00,565,565,0,565
ΑΧΑΪΑΣ,702,60,0,-129,60,2021-01-14T00:00:00,2015,2015,0,2015
ΒΟΙΩΤΙΑΣ,801,0,0,0,0,2021-01-14T00:00:00,360,360,0,360
ΒΟΡΕΙΟΥ ΤΟΜΕΑ ΑΘΗΝΩΝ,902,1818,0,-650,1818,2021-01-14T00:00:00,9824,9824,0,9824
ΓΡΕΒΕΝΩΝ,301,0,0,0,0,2021-01-14T00:00:00,195,195,0,195
ΔΡΑΜΑΣ,101,0,0,0,0,2021-01-14T00:00:00,375,375,0,375
ΔΥΤΙΚΗΣ ΑΤΤΙΚΗΣ,903,19,0,-16,19,2021-01-14T00:00:00,526,526,0,526
ΔΥΤΙΚΟΥ ΤΟΜΕΑ ΑΘΗΝΩΝ,904,160,0,70,160,2021-01-14T00:00:00,2563,2563,0,2563
ΕΒΡΟΥ,102,130,0,-11,130,2021-01-14T00:00:00,965,965,0,965
ΕΥΒΟΙΑΣ,802,0,0,0,0,2021-01-14T00:00:00,575,575,0,575
ΕΥΡΥΤΑΝΙΑΣ,803,0,0,0,0,2021-01-14T00:00:00,145,145,0,145
ΖΑΚΥΝΘΟΥ,601,40,0,-10,40,2021-01-14T00:00:00,140,140,0,140
ΗΛΕΙΑΣ,703,0,0,0,0,2021-01-14T00:00:00,515,515,0,515
ΗΜΑΘΙΑΣ,201,25,0,-5,25,2021-01-14T00:00:00,629,629,0,629
ΗΡΑΚΛΕΙΟΥ,1301,225,0,11,225,2021-01-14T00:00:00,2047,2047,0,2047
ΘΑΣΟΥ,103,0,0,0,0,2021-01-14T00:00:00,0,0,0,0
ΘΕΣΠΡΩΤΙΑΣ,402,0,0,0,0,2021-01-14T00:00:00,225,225,0,225
ΘΕΣΣΑΛΟΝΙΚΗΣ,202,817,0,-392,817,2021-01-14T00:00:00,9340,9340,0,9340
ΘΗΡΑΣ,1202,0,0,0,0,2021-01-14T00:00:00,20,20,0,20
ΙΘΑΚΗΣ,602,0,0,0,0,2021-01-14T00:00:00,0,0,0,0
ΙΚΑΡΙΑΣ,1101,0,0,-5,0,2021-01-14T00:00:00,30,30,0,30
ΙΩΑΝΝΙΝΩΝ,403,121,0,21,121,2021-01-14T00:00:00,2324,2324,0,2324
ΚΑΒΑΛΑΣ,104,5,0,-50,5,2021-01-14T00:00:00,585,585,0,585
ΚΑΛΥΜΝΟΥ,1203,30,0,-58,30,2021-01-14T00:00:00,128,128,0,128
ΚΑΡΔΙΤΣΑΣ,501,0,0,0,0,2021-01-14T00:00:00,544,544,0,544
ΚΑΡΠΑΘΟΥ,1204,0,0,-5,0,2021-01-14T00:00:00,15,15,0,15
ΚΑΣΤΟΡΙΑΣ,302,0,0,-37,0,2021-01-14T00:00:00,276,276,0,276
ΚΕΑΣ-ΚΥΘΝΟΥ,1205,0,0,0,0,2021-01-14T00:00:00,0,0,0,0
ΚΕΝΤΡΙΚΟΥ ΤΟΜΕΑ ΑΘΗΝΩΝ,905,1311,0,-269,1311,2021-01-14T00:00:00,17384,17384,0,17384
ΚΕΡΚΥΡΑΣ,603,0,0,-35,0,2021-01-14T00:00:00,200,200,0,200
ΚΕΦΑΛΛΗΝΙΑΣ,604,0,0,-65,0,2021-01-14T00:00:00,175,175,0,175
ΚΙΛΚΙΣ,203,0,0,0,0,2021-01-14T00:00:00,305,305,0,305
ΚΟΖΑΝΗΣ,303,5,0,-35,5,2021-01-14T00:00:00,678,678,0,678
ΚΟΡΙΝΘΙΑΣ,1003,0,0,-10,0,2021-01-14T00:00:00,300,300,0,300
ΚΩ,1206,45,0,0,45,2021-01-14T00:00:00,90,90,0,90
ΛΑΚΩΝΙΑΣ,1004,0,0,0,0,2021-01-14T00:00:00,399,399,0,399
ΛΑΡΙΣΑΣ,502,4,0,-26,4,2021-01-14T00:00:00,1715,1715,0,1715
ΛΑΣΙΘΙΟΥ,1302,0,0,-41,0,2021-01-14T00:00:00,509,509,0,509
ΛΕΣΒΟΥ,1102,60,0,-25,60,2021-01-14T00:00:00,215,215,0,215
ΛΕΥΚΑΔΑΣ,605,5,0,-10,5,2021-01-14T00:00:00,100,100,0,100
ΛΗΜΝΟΥ,1103,56,0,-8,56,2021-01-14T00:00:00,163,163,0,163
ΜΑΓΝΗΣΙΑΣ,503,45,0,-14,45,2021-01-14T00:00:00,628,628,0,628
ΜΕΣΣΗΝΙΑΣ,1005,5,0,5,5,2021-01-14T00:00:00,565,565,0,565
ΜΗΛΟΥ,1207,0,0,0,0,2021-01-14T00:00:00,0,0,0,0
ΜΥΚΟΝΟΥ,1208,0,0,0,0,2021-01-14T00:00:00,0,0,0,0
ΝΑΞΟΥ,1209,10,0,10,10,2021-01-14T00:00:00,45,45,0,45
ΝΗΣΩΝ,906,0,0,0,0,2021-01-14T00:00:00,25,25,0,25
ΝΟΤΙΟΥ ΤΟΜΕΑ ΑΘΗΝΩΝ,907,361,0,-70,361,2021-01-14T00:00:00,906,906,0,906
ΞΑΝΘΗΣ,105,5,0,-10,5,2021-01-14T00:00:00,505,505,0,505
ΠΑΡΟΥ,1210,0,0,0,0,2021-01-14T00:00:00,0,0,0,0
ΠΕΙΡΑΙΩΣ,908,274,0,-328,274,2021-01-14T00:00:00,2706,2706,0,2706
ΠΕΛΛΑΣ,204,0,0,0,0,2021-01-14T00:00:00,525,525,0,525
ΠΙΕΡΙΑΣ,205,10,0,0,10,2021-01-14T00:00:00,393,393,0,393
ΠΡΕΒΕΖΑΣ,404,0,0,0,0,2021-01-14T00:00:00,320,320,0,320
ΡΕΘΥΜΝΟΥ,1303,40,0,-25,40,2021-01-14T00:00:00,405,405,0,405
ΡΟΔΟΠΗΣ,106,0,0,-35,0,2021-01-14T00:00:00,295,295,0,295
ΡΟΔΟΥ,1211,115,0,0,115,2021-01-14T00:00:00,340,340,0,340
ΣΑΜΟΥ,1104,45,0,-5,45,2021-01-14T00:00:00,155,155,0,155
ΣΕΡΡΩΝ,206,10,0,-80,10,2021-01-14T00:00:00,610,610,0,610
ΣΠΟΡΑΔΩΝ,504,0,0,0,0,2021-01-14T00:00:00,0,0,0,0
ΣΥΡΟΥ,1212,50,0,0,50,2021-01-14T00:00:00,150,150,0,150
ΤΗΝΟΥ,1213,0,0,0,0,2021-01-14T00:00:00,0,0,0,0
ΤΡΙΚΑΛΩΝ,505,0,0,-15,0,2021-01-14T00:00:00,635,635,0,635
ΦΘΙΩΤΙΔΑΣ,804,23,0,-17,23,2021-01-14T00:00:00,638,638,0,638
ΦΛΩΡΙΝΑΣ,304,0,0,0,0,2021-01-14T00:00:00,241,241,0,241
ΦΩΚΙΔΑΣ,805,0,0,0,0,2021-01-14T00:00:00,105,105,0,105
ΧΑΛΚΙΔΙΚΗΣ,207,0,0,0,0,2021-01-14T00:00:00,245,245,0,245
ΧΑΝΙΩΝ,1304,0,0,0,0,2021-01-14T00:00:00,929,929,0,929
ΧΙΟΥ,1105,45,0,-20,45,2021-01-14T00:00:00,180,180,0,180
ΑΙΤΩΛΟΑΚΑΡΝΑΝΙΑΣ,701,26,0,-28,26,2021-01-15T00:00:00,819,819,0,819
ΑΝΑΤΟΛΙΚΗΣ ΑΤΤΙΚΗΣ,901,0,0,0,0,2021-01-15T00:00:00,707,707,0,707
ΑΝΔΡΟΥ,1201,0,0,0,0,2021-01-15T00:00:00,0,0,0,0
ΑΡΓΟΛΙΔΑΣ,1001,0,0,0,0,2021-01-15T00:00:00,260,260,0,260
ΑΡΚΑΔΙΑΣ,1002,0,0,0,0,2021-01-15T00:00:00,495,495,0,495
ΑΡΤΑΣ,401,0,0,0,0,2021-01-15T00:00:00,565,565,0,565
ΑΧΑΪΑΣ,702,65,0,5,65,2021-01-15T00:00:00,2080,2080,0,2080
ΒΟΙΩΤΙΑΣ,801,0,0,0,0,2021-01-15T00:00:00,360,360,0,360
ΒΟΡΕΙΟΥ ΤΟΜΕΑ ΑΘΗΝΩΝ,902,1841,0,23,1841,2021-01-15T00:00:00,11665,11665,0,11665
ΓΡΕΒΕΝΩΝ,301,0,0,0,0,2021-01-15T00:00:00,195,195,0,195
ΔΡΑΜΑΣ,101,0,0,0,0,2021-01-15T00:00:00,375,375,0,375
ΔΥΤΙΚΗΣ ΑΤΤΙΚΗΣ,903,24,0,5,24,2021-01-15T00:00:00,550,550,0,550
ΔΥΤΙΚΟΥ ΤΟΜΕΑ ΑΘΗΝΩΝ,904,120,0,-40,120,2021-01-15T00:00:00,2683,2683,0,2683
ΕΒΡΟΥ,102,124,0,-6,124,2021-01-15T00:00:00,1089,1089,0,1089
ΕΥΒΟΙΑΣ,802,0,0,0,0,2021-01-15T00:00:00,575,575,0,575
ΕΥΡΥΤΑΝΙΑΣ,803,0,0,0,0,2021-01-15T00:00:00,145,145,0,145
ΖΑΚΥΝΘΟΥ,601,0,0,-40,0,2021-01-15T00:00:00,140,140,0,140
ΗΛΕΙΑΣ,703,0,0,0,0,2021-01-15T00:00:00,515,515,0,515
ΗΜΑΘΙΑΣ,201,0,0,-25,0,2021-01-15T00:00:00,629,629,0,629
ΗΡΑΚΛΕΙΟΥ,1301,233,0,8,233,2021-01-15T00:00:00,2280,2280,0,2280
ΘΑΣΟΥ,103,0,0,0,0,2021-01-15T00:00:00,0,0,0,0
ΘΕΣΠΡΩΤΙΑΣ,402,0,0,0,0,2021-01-15T00:00:00,225,225,0,225
ΘΕΣΣΑΛΟΝΙΚΗΣ,202,760,0,-57,760,2021-01-15T00:00:00,10100,10100,0,10100
ΘΗΡΑΣ,1202,0,0,0,0,2021-01-15T00:00:00,20,20,0,20
ΙΘΑΚΗΣ,602,0,0,0,0,2021-01-15T00:00:00,0,0,0,0
ΙΚΑΡΙΑΣ,1101,0,0,0,0,2021-01-15T00:00:00,30,30,0,30
ΙΩΑΝΝΙΝΩΝ,403,104,0,-17,104,2021-01-15T00:00:00,2428,2428,0,2428
ΚΑΒΑΛΑΣ,104,0,0,-5,0,2021-01-15T00:00:00,585,585,0,585
ΚΑΛΥΜΝΟΥ,1203,0,0,-30,0,2021-01-15T00:00:00,128,128,0,128
ΚΑΡΔΙΤΣΑΣ,501,0,0,0,0,2021-01-15T00:00:00,544,544,0,544
ΚΑΡΠΑΘΟΥ,1204,0,0,0,0,2021-01-15T00:00:00,15,15,0,15
ΚΑΣΤΟΡΙΑΣ,302,0,0,0,0,2021-01-15T00:00:00,276,276,0,276
ΚΕΑΣ-ΚΥΘΝΟΥ,1205,0,0,0,0,2021-01-15T00:00:00,0,0,0,0
ΚΕΝΤΡΙΚΟΥ ΤΟΜΕΑ ΑΘΗΝΩΝ,905,549,0,-762,549,2021-01-15T00:00:00,17933,17933,0,17933
ΚΕΡΚΥΡΑΣ,603,0,0,0,0,2021-01-15T00:00:00,200,200,0,200
ΚΕΦΑΛΛΗΝΙΑΣ,604,0,0,0,0,2021-01-15T00:00:00,175,175,0,175
ΚΙΛΚΙΣ,203,0,0,0,0,2021-01-15T00:00:00,305,305,0,305
ΚΟΖΑΝΗΣ,303,25,0,20,25,2021-01-15T00:00:00,703,703,0,703
ΚΟΡΙΝΘΙΑΣ,1003,0,0,0,0,2021-01-15T00:00:00,300,300,0,300
ΚΩ,1206,0,0,-45,0,2021-01-15T00:00:00,90,90,0,90
ΛΑΚΩΝΙΑΣ,1004,0,0,0,0,2021-01-15T00:00:00,399,399,0,399
ΛΑΡΙΣΑΣ,502,11,0,7,11,2021-01-15T00:00:00,1726,1726,0,1726
ΛΑΣΙΘΙΟΥ,1302,10,0,10,10,2021-01-15T00:00:00,519,519,0,519
ΛΕΣΒΟΥ,1102,0,0,-60,0,2021-01-15T00:00:00,215,215,0,215
ΛΕΥΚΑΔΑΣ,605,0,0,-5,0,2021-01-15T00:00:00,100,100,0,100
ΛΗΜΝΟΥ,1103,0,0,-56,0,2021-01-15T00:00:00,163,163,0,163
ΜΑΓΝΗΣΙΑΣ,503,5,0,-40,5,2021-01-15T00:00:00,633,633,0,633
ΜΕΣΣΗΝΙΑΣ,1005,0,0,-5,0,2021-01-15T00:00:00,565,565,0,565
ΜΗΛΟΥ,1207,0,0,0,0,2021-01-15T00:00:00,0,0,0,0
ΜΥΚΟΝΟΥ,1208,0,0,0,0,2021-01-15T00:00:00,0,0,0,0
ΝΑΞΟΥ,1209,0,0,-10,0,2021-01-15T00:00:00,45,45,0,45
ΝΗΣΩΝ,906,0,0,0,0,2021-01-15T00:00:00,25,25,0,25
ΝΟΤΙΟΥ ΤΟΜΕΑ ΑΘΗΝΩΝ,907,234,0,-127,234,2021-01-15T00:00:00,1140,1140,0,1140
ΞΑΝΘΗΣ,105,5,0,0,5,2021-01-15T00:00:00,510,510,0,510
ΠΑΡΟΥ,1210,0,0,0,0,2021-01-15T00:00:00,0,0,0,0
ΠΕΙΡΑΙΩΣ,908,0,0,-274,0,2021-01-15T00:00:00,2706,2706,0,2706
ΠΕΛΛΑΣ,204,0,0,0,0,2021-01-15T00:00:00,525,525,0,525
ΠΙΕΡΙΑΣ,205,10,0,0,10,2021-01-15T00:00:00,403,403,0,403
ΠΡΕΒΕΖΑΣ,404,0,0,0,0,2021-01-15T00:00:00,320,320,0,320
ΡΕΘΥΜΝΟΥ,1303,50,0,10,50,2021-01-15T00:00:00,455,455,0,455
ΡΟΔΟΠΗΣ,106,0,0,0,0,2021-01-15T00:00:00,295,295,0,295
ΡΟΔΟΥ,1211,95,0,-20,95,2021-01-15T00:00:00,435,435,0,435
ΣΑΜΟΥ,1104,35,0,-10,35,2021-01-15T00:00:00,190,190,0,190
ΣΕΡΡΩΝ,206,0,0,-10,0,2021-01-15T00:00:00,610,610,0,610
ΣΠΟΡΑΔΩΝ,504,0,0,0,0,2021-01-15T00:00:00,0,0,0,0
ΣΥΡΟΥ,1212,20,0,-30,20,2021-01-15T00:00:00,170,170,0,170
ΤΗΝΟΥ,1213,0,0,0,0,2021-01-15T00:00:00,0,0,0,0
ΤΡΙΚΑΛΩΝ,505,0,0,0,0,2021-01-15T00:00:00,635,635,0,635
ΦΘΙΩΤΙΔΑΣ,804,46,0,23,46,2021-01-15T00:00:00,684,684,0,684
ΦΛΩΡΙΝΑΣ,304,0,0,0,0,2021-01-15T00:00:00,241,241,0,241
ΦΩΚΙΔΑΣ,805,0,0,0,0,2021-01-15T00:00:00,105,105,0,105
ΧΑΛΚΙΔΙΚΗΣ,207,0,0,0,0,2021-01-15T00:00:00,245,245,0,245
ΧΑΝΙΩΝ,1304,0,0,0,0,2021-01-15T00:00:00,929,929,0,929
ΧΙΟΥ,1105,60,0,15,60,2021-01-15T00:00:00,240,240,0,240
ΑΙΤΩΛΟΑΚΑΡΝΑΝΙΑΣ,701,30,0,4,30,2021-01-16T00:00:00,849,849,0,849
ΑΝΑΤΟΛΙΚΗΣ ΑΤΤΙΚΗΣ,901,20,0,20,20,2021-01-16T00:00:00,727,727,0,727
ΑΝΔΡΟΥ,1201,0,0,0,0,2021-01-16T00:00:00,0,0,0,0
ΑΡΓΟΛΙΔΑΣ,1001,65,0,65,65,2021-01-16T00:00:00,325,325,0,325
ΑΡΚΑΔΙΑΣ,1002,30,0,30,30,2021-01-16T00:00:00,525,525,0,525
ΑΡΤΑΣ,401,25,0,25,25,2021-01-16T00:00:00,590,590,0,590
ΑΧΑΪΑΣ,702,120,0,55,120,2021-01-16T00:00:00,2200,2200,0,2200
ΒΟΙΩΤΙΑΣ,801,15,0,15,15,2021-01-16T00:00:00,375,375,0,375
ΒΟΡΕΙΟΥ ΤΟΜΕΑ ΑΘΗΝΩΝ,902,683,0,-1158,683,2021-01-16T00:00:00,12348,12348,0,12348
ΓΡΕΒΕΝΩΝ,301,20,0,20,20,2021-01-16T00:00:00,215,215,0,215
ΔΡΑΜΑΣ,101,50,0,50,50,2021-01-16T00:00:00,425,425,0,425
ΔΥΤΙΚΗΣ ΑΤΤΙΚΗΣ,903,15,0,-9,15,2021-01-16T00:00:00,565,565,0,565
ΔΥΤΙΚΟΥ ΤΟΜΕΑ ΑΘΗΝΩΝ,904,124,0,4,124,2021-01-16T00:00:00,2807,2807,0,2807
ΕΒΡΟΥ,102,106,0,-18,106,2021-01-16T00:00:00,1195,1195,0,1195
ΕΥΒΟΙΑΣ,802,48,0,48,48,2021-01-16T00:00:00,623,623,0,623
ΕΥΡΥΤΑΝΙΑΣ,803,15,0,15,15,2021-01-16T00:00:00,160,160,0,160
ΖΑΚΥΝΘΟΥ,601,30,0,30,30,2021-01-16T00:00:00,170,170,0,170
ΗΛΕΙΑΣ,703,52,0,52,52,2021-01-16T00:00:00,567,567,0,567
ΗΜΑΘΙΑΣ,201,29,0,29,29,2021-01-16T00:00:00,658,658,0,658
ΗΡΑΚΛΕΙΟΥ,1301,307,0,74,307,2021-01-16T00:00:00,2587,2587,0,2587
ΘΑΣΟΥ,103,0,0,0,0,2021-01-16T00:00:00,0,0,0,0
ΘΕΣΠΡΩΤΙΑΣ,402,50,0,50,50,2021-01-16T00:00:00,275,275,0,275
ΘΕΣΣΑΛΟΝΙΚΗΣ,202,610,0,-150,610,2021-01-16T00:00:00,10710,10710,0,10710
ΘΗΡΑΣ,1202,10,0,10,10,2021-01-16T00:00:00,30,30,0,30
ΙΘΑΚΗΣ,602,0,0,0,0,2021-01-16T00:00:00,0,0,0,0
ΙΚΑΡΙΑΣ,1101,5,0,5,5,2021-01-16T00:00:00,35,35,0,35
ΙΩΑΝΝΙΝΩΝ,403,136,0,32,136,2021-01-16T00:00:00,2564,2564,0,2564
ΚΑΒΑΛΑΣ,104,55,0,55,55,2021-01-16T00:00:00,640,640,0,640
ΚΑΛΥΜΝΟΥ,1203,5,0,5,5,2021-01-16T00:00:00,133,133,0,133
ΚΑΡΔΙΤΣΑΣ,501,45,0,45,45,2021-01-16T00:00:00,589,589,0,589
ΚΑΡΠΑΘΟΥ,1204,0,0,0,0,2021-01-16T00:00:00,15,15,0,15
ΚΑΣΤΟΡΙΑΣ,302,21,0,21,21,2021-01-16T00:00:00,297,297,0,297
ΚΕΑΣ-ΚΥΘΝΟΥ,1205,0,0,0,0,2021-01-16T00:00:00,0,0,0,0
ΚΕΝΤΡΙΚΟΥ ΤΟΜΕΑ ΑΘΗΝΩΝ,905,1032,2,485,1034,2021-01-16T00:00:00,18965,18965,2,18967
ΚΕΡΚΥΡΑΣ,603,55,0,55,55,2021-01-16T00:00:00,255,255,0,255
ΚΕΦΑΛΛΗΝΙΑΣ,604,45,0,45,45,2021-01-16T00:00:00,220,220,0,220
ΚΙΛΚΙΣ,203,35,0,35,35,2021-01-16T00:00:00,340,340,0,340
ΚΟΖΑΝΗΣ,303,37,0,12,37,2021-01-16T00:00:00,740,740,0,740
ΚΟΡΙΝΘΙΑΣ,1003,20,0,20,20,2021-01-16T00:00:00,320,320,0,320
ΚΩ,1206,17,0,17,17,2021-01-16T00:00:00,107,107,0,107
ΛΑΚΩΝΙΑΣ,1004,30,0,30,30,2021-01-16T00:00:00,429,429,0,429
ΛΑΡΙΣΑΣ,502,120,0,109,120,2021-01-16T00:00:00,1846,1846,0,1846
ΛΑΣΙΘΙΟΥ,1302,40,0,30,40,2021-01-16T00:00:00,559,559,0,559
ΛΕΣΒΟΥ,1102,35,0,35,35,2021-01-16T00:00:00,250,250,0,250
ΛΕΥΚΑΔΑΣ,605,15,0,15,15,2021-01-16T00:00:00,115,115,0,115
ΛΗΜΝΟΥ,1103,5,0,5,5,2021-01-16T00:00:00,168,168,0,168
ΜΑΓΝΗΣΙΑΣ,503,0,0,-5,0,2021-01-16T00:00:00,633,633,0,633
ΜΕΣΣΗΝΙΑΣ,1005,45,0,45,45,2021-01-16T00:00:00,610,610,0,610
ΜΗΛΟΥ,1207,0,0,0,0,2021-01-16T00:00:00,0,0,0,0
ΜΥΚΟΝΟΥ,1208,0,0,0,0,2021-01-16T00:00:00,0,0,0,0
ΝΑΞΟΥ,1209,5,0,5,5,2021-01-16T00:00:00,50,50,0,50
ΝΗΣΩΝ,906,15,0,15,15,2021-01-16T00:00:00,40,40,0,40
ΝΟΤΙΟΥ ΤΟΜΕΑ ΑΘΗΝΩΝ,907,135,0,-99,135,2021-01-16T00:00:00,1275,1275,0,1275
ΞΑΝΘΗΣ,105,45,0,40,45,2021-01-16T00:00:00,555,555,0,555
ΠΑΡΟΥ,1210,0,0,0,0,2021-01-16T00:00:00,0,0,0,0
ΠΕΙΡΑΙΩΣ,908,145,0,145,145,2021-01-16T00:00:00,2851,2851,0,2851
ΠΕΛΛΑΣ,204,28,0,28,28,2021-01-16T00:00:00,553,553,0,553
ΠΙΕΡΙΑΣ,205,30,0,20,30,2021-01-16T00:00:00,433,433,0,433
ΠΡΕΒΕΖΑΣ,404,19,0,19,19,2021-01-16T00:00:00,339,339,0,339
ΡΕΘΥΜΝΟΥ,1303,15,0,-35,15,2021-01-16T00:00:00,470,470,0,470
ΡΟΔΟΠΗΣ,106,25,0,25,25,2021-01-16T00:00:00,320,320,0,320
ΡΟΔΟΥ,1211,0,0,-95,0,2021-01-16T00:00:00,435,435,0,435
ΣΑΜΟΥ,1104,10,0,-25,10,2021-01-16T00:00:00,200,200,0,200
ΣΕΡΡΩΝ,206,40,0,40,40,2021-01-16T00:00:00,650,650,0,650
ΣΠΟΡΑΔΩΝ,504,0,0,0,0,2021-01-16T00:00:00,0,0,0,0
ΣΥΡΟΥ,1212,0,0,-20,0,2021-01-16T00:00:00,170,170,0,170
ΤΗΝΟΥ,1213,0,0,0,0,2021-01-16T00:00:00,0,0,0,0
ΤΡΙΚΑΛΩΝ,505,45,0,45,45,2021-01-16T00:00:00,680,680,0,680
ΦΘΙΩΤΙΔΑΣ,804,36,0,-10,36,2021-01-16T00:00:00,720,720,0,720
ΦΛΩΡΙΝΑΣ,304,23,0,23,23,2021-01-16T00:00:00,264,264,0,264
ΦΩΚΙΔΑΣ,805,15,0,15,15,2021-01-16T00:00:00,120,120,0,120
ΧΑΛΚΙΔΙΚΗΣ,207,20,0,20,20,2021-01-16T00:00:00,265,265,0,265
ΧΑΝΙΩΝ,1304,54,0,54,54,2021-01-16T00:00:00,983,983,0,983
ΧΙΟΥ,1105,20,0,-40,20,2021-01-16T00:00:00,260,260,0,260
ΑΙΤΩΛΟΑΚΑΡΝΑΝΙΑΣ,701,40,0,10,40,2021-01-18T00:00:00,889,889,0,889
ΑΝΑΤΟΛΙΚΗΣ ΑΤΤΙΚΗΣ,901,40,57,77,97,2021-01-18T00:00:00,767,767,57,824
ΑΝΔΡΟΥ,1201,0,0,0,0,2021-01-18T00:00:00,0,0,0,0
ΑΡΓΟΛΙΔΑΣ,1001,51,0,-14,51,2021-01-18T00:00:00,376,376,0,376
ΑΡΚΑΔΙΑΣ,1002,40,0,10,40,2021-01-18T00:00:00,565,565,0,565
ΑΡΤΑΣ,401,26,0,1,26,2021-01-18T00:00:00,616,616,0,616
ΑΧΑΪΑΣ,702,193,0,73,193,2021-01-18T00:00:00,2393,2393,0,2393
ΒΟΙΩΤΙΑΣ,801,36,0,21,36,2021-01-18T00:00:00,411,411,0,411
ΒΟΡΕΙΟΥ ΤΟΜΕΑ ΑΘΗΝΩΝ,902,687,0,4,687,2021-01-18T00:00:00,13035,13035,0,13035
ΓΡΕΒΕΝΩΝ,301,30,0,10,30,2021-01-18T00:00:00,245,245,0,245
ΔΡΑΜΑΣ,101,38,0,-12,38,2021-01-18T00:00:00,463,463,0,463
ΔΥΤΙΚΗΣ ΑΤΤΙΚΗΣ,903,15,85,85,100,2021-01-18T00:00:00,580,580,85,665
ΔΥΤΙΚΟΥ ΤΟΜΕΑ ΑΘΗΝΩΝ,904,64,103,43,167,2021-01-18T00:00:00,2871,2871,103,2974
ΕΒΡΟΥ,102,113,0,7,113,2021-01-18T00:00:00,1308,1308,0,1308
ΕΥΒΟΙΑΣ,802,103,0,55,103,2021-01-18T00:00:00,726,726,0,726
ΕΥΡΥΤΑΝΙΑΣ,803,15,0,0,15,2021-01-18T00:00:00,175,175,0,175
ΖΑΚΥΝΘΟΥ,601,20,0,-10,20,2021-01-18T00:00:00,190,190,0,190
ΗΛΕΙΑΣ,703,70,0,18,70,2021-01-18T00:00:00,637,637,0,637
ΗΜΑΘΙΑΣ,201,50,0,21,50,2021-01-18T00:00:00,708,708,0,708
ΗΡΑΚΛΕΙΟΥ,1301,449,0,142,449,2021-01-18T00:00:00,3036,3036,0,3036
ΘΑΣΟΥ,103,0,0,0,0,2021-01-18T00:00:00,0,0,0,0
ΘΕΣΠΡΩΤΙΑΣ,402,31,0,-19,31,2021-01-18T00:00:00,306,306,0,306
ΘΕΣΣΑΛΟΝΙΚΗΣ,202,638,0,28,638,2021-01-18T00:00:00,11348,11348,0,11348
ΘΗΡΑΣ,1202,5,0,-5,5,2021-01-18T00:00:00,35,35,0,35
ΙΘΑΚΗΣ,602,0,0,0,0,2021-01-18T00:00:00,0,0,0,0
ΙΚΑΡΙΑΣ,1101,5,0,0,5,2021-01-18T00:00:00,40,40,0,40
ΙΩΑΝΝΙΝΩΝ,403,170,0,34,170,2021-01-18T00:00:00,2734,2734,0,2734
ΚΑΒΑΛΑΣ,104,59,0,4,59,2021-01-18T00:00:00,699,699,0,699
ΚΑΛΥΜΝΟΥ,1203,12,0,7,12,2021-01-18T00:00:00,145,145,0,145
ΚΑΡΔΙΤΣΑΣ,501,55,0,10,55,2021-01-18T00:00:00,644,644,0,644
ΚΑΡΠΑΘΟΥ,1204,0,0,0,0,2021-01-18T00:00:00,15,15,0,15
ΚΑΣΤΟΡΙΑΣ,302,28,0,7,28,2021-01-18T00:00:00,325,325,0,325
ΚΕΑΣ-ΚΥΘΝΟΥ,1205,0,0,0,0,2021-01-18T00:00:00,0,0,0,0
ΚΕΝΤΡΙΚΟΥ ΤΟΜΕΑ ΑΘΗΝΩΝ,905,686,176,-172,862,2021-01-18T00:00:00,19651,19651,178,19829
ΚΕΡΚΥΡΑΣ,603,65,0,10,65,2021-01-18T00:00:00,320,320,0,320
ΚΕΦΑΛΛΗΝΙΑΣ,604,20,0,-25,20,2021-01-18T00:00:00,240,240,0,240
ΚΙΛΚΙΣ,203,40,0,5,40,2021-01-18T00:00:00,380,380,0,380
ΚΟΖΑΝΗΣ,303,44,0,7,44,2021-01-18T00:00:00,784,784,0,784
ΚΟΡΙΝΘΙΑΣ,1003,30,0,10,30,2021-01-18T00:00:00,350,350,0,350
ΚΩ,1206,26,0,9,26,2021-01-18T00:00:00,133,133,0,133
ΛΑΚΩΝΙΑΣ,1004,73,0,43,73,2021-01-18T00:00:00,502,502,0,502
ΛΑΡΙΣΑΣ,502,155,0,35,155,2021-01-18T00:00:00,2001,2001,0,2001
ΛΑΣΙΘΙΟΥ,1302,40,0,0,40,2021-01-18T00:00:00,599,599,0,599
ΛΕΣΒΟΥ,1102,34,0,-1,34,2021-01-18T00:00:00,284,284,0,284
ΛΕΥΚΑΔΑΣ,605,20,0,5,20,2021-01-18T00:00:00,135,135,0,135
ΛΗΜΝΟΥ,1103,5,0,0,5,2021-01-18T00:00:00,173,173,0,173
ΜΑΓΝΗΣΙΑΣ,503,0,0,0,0,2021-01-18T00:00:00,633,633,0,633
ΜΕΣΣΗΝΙΑΣ,1005,55,0,10,55,2021-01-18T00:00:00,665,665,0,665
ΜΗΛΟΥ,1207,0,0,0,0,2021-01-18T00:00:00,0,0,0,0
ΜΥΚΟΝΟΥ,1208,0,0,0,0,2021-01-18T00:00:00,0,0,0,0
ΝΑΞΟΥ,1209,10,0,5,10,2021-01-18T00:00:00,60,60,0,60
ΝΗΣΩΝ,906,0,0,-15,0,2021-01-18T00:00:00,40,40,0,40
ΝΟΤΙΟΥ ΤΟΜΕΑ ΑΘΗΝΩΝ,907,65,0,-70,65,2021-01-18T00:00:00,1340,1340,0,1340
ΞΑΝΘΗΣ,105,55,0,10,55,2021-01-18T00:00:00,610,610,0,610
ΠΑΡΟΥ,1210,0,0,0,0,2021-01-18T00:00:00,0,0,0,0
ΠΕΙΡΑΙΩΣ,908,114,0,-31,114,2021-01-18T00:00:00,2965,2965,0,2965
ΠΕΛΛΑΣ,204,51,0,23,51,2021-01-18T00:00:00,604,604,0,604
ΠΙΕΡΙΑΣ,205,35,0,5,35,2021-01-18T00:00:00,468,468,0,468
ΠΡΕΒΕΖΑΣ,404,24,0,5,24,2021-01-18T00:00:00,363,363,0,363
ΡΕΘΥΜΝΟΥ,1303,25,0,10,25,2021-01-18T00:00:00,495,495,0,495
ΡΟΔΟΠΗΣ,106,25,0,0,25,2021-01-18T00:00:00,345,345,0,345
ΡΟΔΟΥ,1211,0,0,0,0,2021-01-18T00:00:00,435,435,0,435
ΣΑΜΟΥ,1104,10,0,0,10,2021-01-18T00:00:00,210,210,0,210
ΣΕΡΡΩΝ,206,40,0,0,40,2021-01-18T00:00:00,690,690,0,690
ΣΠΟΡΑΔΩΝ,504,0,0,0,0,2021-01-18T00:00:00,0,0,0,0
ΣΥΡΟΥ,1212,0,0,0,0,2021-01-18T00:00:00,170,170,0,170
ΤΗΝΟΥ,1213,0,0,0,0,2021-01-18T00:00:00,0,0,0,0
ΤΡΙΚΑΛΩΝ,505,75,0,30,75,2021-01-18T00:00:00,755,755,0,755
ΦΘΙΩΤΙΔΑΣ,804,53,0,17,53,2021-01-18T00:00:00,773,773,0,773
ΦΛΩΡΙΝΑΣ,304,20,0,-3,20,2021-01-18T00:00:00,284,284,0,284
ΦΩΚΙΔΑΣ,805,6,0,-9,6,2021-01-18T00:00:00,126,126,0,126
ΧΑΛΚΙΔΙΚΗΣ,207,15,0,-5,15,2021-01-18T00:00:00,280,280,0,280
ΧΑΝΙΩΝ,1304,60,0,6,60,2021-01-18T00:00:00,1043,1043,0,1043
ΧΙΟΥ,1105,27,0,7,27,2021-01-18T00:00:00,287,287,0,287
ΑΙΤΩΛΟΑΚΑΡΝΑΝΙΑΣ,701,54,0,14,54,2021-01-19T00:00:00,943,943,0,943
ΑΝΑΤΟΛΙΚΗΣ ΑΤΤΙΚΗΣ,901,47,85,35,132,2021-01-19T00:00:00,814,814,142,956
ΑΝΔΡΟΥ,1201,0,0,0,0,2021-01-19T00:00:00,0,0,0,0
ΑΡΓΟΛΙΔΑΣ,1001,131,0,80,131,2021-01-19T00:00:00,507,507,0,507
ΑΡΚΑΔΙΑΣ,1002,48,0,8,48,2021-01-19T00:00:00,613,613,0,613
ΑΡΤΑΣ,401,30,0,4,30,2021-01-19T00:00:00,646,646,0,646
ΑΧΑΪΑΣ,702,159,93,59,252,2021-01-19T00:00:00,2552,2552,93,2645
ΒΟΙΩΤΙΑΣ,801,59,0,23,59,2021-01-19T00:00:00,470,470,0,470
ΒΟΡΕΙΟΥ ΤΟΜΕΑ ΑΘΗΝΩΝ,902,1283,0,596,1283,2021-01-19T00:00:00,14318,14318,0,14318
ΓΡΕΒΕΝΩΝ,301,34,0,4,34,2021-01-19T00:00:00,279,279,0,279
ΔΡΑΜΑΣ,101,60,0,22,60,2021-01-19T00:00:00,523,523,0,523
ΔΥΤΙΚΗΣ ΑΤΤΙΚΗΣ,903,19,57,-24,76,2021-01-19T00:00:00,599,599,142,741
ΔΥΤΙΚΟΥ ΤΟΜΕΑ ΑΘΗΝΩΝ,904,204,51,88,255,2021-01-19T00:00:00,3075,3075,154,3229
ΕΒΡΟΥ,102,148,0,35,148,2021-01-19T00:00:00,1456,1456,0,1456
ΕΥΒΟΙΑΣ,802,200,0,97,200,2021-01-19T00:00:00,926,926,0,926
ΕΥΡΥΤΑΝΙΑΣ,803,36,0,21,36,2021-01-19T00:00:00,211,211,0,211
ΖΑΚΥΝΘΟΥ,601,60,0,40,60,2021-01-19T00:00:00,250,250,0,250
ΗΛΕΙΑΣ,703,133,0,63,133,2021-01-19T00:00:00,770,770,0,770
ΗΜΑΘΙΑΣ,201,60,0,10,60,2021-01-19T00:00:00,768,768,0,768
ΗΡΑΚΛΕΙΟΥ,1301,347,0,-102,347,2021-01-19T00:00:00,3383,3383,0,3383
ΘΑΣΟΥ,103,0,0,0,0,2021-01-19T00:00:00,0,0,0,0
ΘΕΣΠΡΩΤΙΑΣ,402,79,0,48,79,2021-01-19T00:00:00,385,385,0,385
ΘΕΣΣΑΛΟΝΙΚΗΣ,202,755,59,176,814,2021-01-19T00:00:00,12103,12103,59,12162
ΘΗΡΑΣ,1202,30,0,25,30,2021-01-19T00:00:00,65,65,0,65
ΙΘΑΚΗΣ,602,0,0,0,0,2021-01-19T00:00:00,0,0,0,0
ΙΚΑΡΙΑΣ,1101,24,0,19,24,2021-01-19T00:00:00,64,64,0,64
ΙΩΑΝΝΙΝΩΝ,403,139,76,45,215,2021-01-19T00:00:00,2873,2873,76,2949
ΚΑΒΑΛΑΣ,104,60,0,1,60,2021-01-19T00:00:00,759,759,0,759
ΚΑΛΥΜΝΟΥ,1203,6,0,-6,6,2021-01-19T00:00:00,151,151,0,151
ΚΑΡΔΙΤΣΑΣ,501,65,0,10,65,2021-01-19T00:00:00,709,709,0,709
ΚΑΡΠΑΘΟΥ,1204,0,0,0,0,2021-01-19T00:00:00,15,15,0,15
ΚΑΣΤΟΡΙΑΣ,302,30,0,2,30,2021-01-19T00:00:00,355,355,0,355
ΚΕΑΣ-ΚΥΘΝΟΥ,1205,0,0,0,0,2021-01-19T00:00:00,0,0,0,0
ΚΕΝΤΡΙΚΟΥ ΤΟΜΕΑ ΑΘΗΝΩΝ,905,963,133,234,1096,2021-01-19T00:00:00,20614,20614,311,20925
ΚΕΡΚΥΡΑΣ,603,108,0,43,108,2021-01-19T00:00:00,428,428,0,428
ΚΕΦΑΛΛΗΝΙΑΣ,604,130,0,110,130,2021-01-19T00:00:00,370,370,0,370
ΚΙΛΚΙΣ,203,66,0,26,66,2021-01-19T00:00:00,446,446,0,446
ΚΟΖΑΝΗΣ,303,121,0,77,121,2021-01-19T00:00:00,905,905,0,905
ΚΟΡΙΝΘΙΑΣ,1003,30,0,0,30,2021-01-19T00:00:00,380,380,0,380
ΚΩ,1206,60,0,34,60,2021-01-19T00:00:00,193,193,0,193
ΛΑΚΩΝΙΑΣ,1004,137,0,64,137,2021-01-19T00:00:00,639,639,0,639
ΛΑΡΙΣΑΣ,502,103,95,43,198,2021-01-19T00:00:00,2104,2104,95,2199
ΛΑΣΙΘΙΟΥ,1302,194,0,154,194,2021-01-19T00:00:00,793,793,0,793
ΛΕΣΒΟΥ,1102,168,0,134,168,2021-01-19T00:00:00,452,452,0,452
ΛΕΥΚΑΔΑΣ,605,36,0,16,36,2021-01-19T00:00:00,171,171,0,171
ΛΗΜΝΟΥ,1103,54,0,49,54,2021-01-19T00:00:00,227,227,0,227
ΜΑΓΝΗΣΙΑΣ,503,49,0,49,49,2021-01-19T00:00:00,682,682,0,682
ΜΕΣΣΗΝΙΑΣ,1005,105,0,50,105,2021-01-19T00:00:00,770,770,0,770
ΜΗΛΟΥ,1207,0,0,0,0,2021-01-19T00:00:00,0,0,0,0
ΜΥΚΟΝΟΥ,1208,0,0,0,0,2021-01-19T00:00:00,0,0,0,0
ΝΑΞΟΥ,1209,12,0,2,12,2021-01-19T00:00:00,72,72,0,72
ΝΗΣΩΝ,906,24,0,24,24,2021-01-19T00:00:00,64,64,0,64
ΝΟΤΙΟΥ ΤΟΜΕΑ ΑΘΗΝΩΝ,907,102,0,37,102,2021-01-19T00:00:00,1442,1442,0,1442
ΞΑΝΘΗΣ,105,60,0,5,60,2021-01-19T00:00:00,670,670,0,670
ΠΑΡΟΥ,1210,0,0,0,0,2021-01-19T00:00:00,0,0,0,0
ΠΕΙΡΑΙΩΣ,908,227,0,113,227,2021-01-19T00:00:00,3192,3192,0,3192
ΠΕΛΛΑΣ,204,80,0,29,80,2021-01-19T00:00:00,684,684,0,684
ΠΙΕΡΙΑΣ,205,54,0,19,54,2021-01-19T00:00:00,522,522,0,522
ΠΡΕΒΕΖΑΣ,404,48,0,24,48,2021-01-19T00:00:00,411,411,0,411
ΡΕΘΥΜΝΟΥ,1303,30,0,5,30,2021-01-19T00:00:00,525,525,0,525
ΡΟΔΟΠΗΣ,106,48,0,23,48,2021-01-19T00:00:00,393,393,0,393
ΡΟΔΟΥ,1211,90,0,90,90,2021-01-19T00:00:00,525,525,0,525
ΣΑΜΟΥ,1104,30,0,20,30,2021-01-19T00:00:00,240,240,0,240
ΣΕΡΡΩΝ,206,72,0,32,72,2021-01-19T00:00:00,762,762,0,762
ΣΠΟΡΑΔΩΝ,504,0,0,0,0,2021-01-19T00:00:00,0,0,0,0
ΣΥΡΟΥ,1212,29,0,29,29,2021-01-19T00:00:00,199,199,0,199
ΤΗΝΟΥ,1213,0,0,0,0,2021-01-19T00:00:00,0,0,0,0
ΤΡΙΚΑΛΩΝ,505,72,0,-3,72,2021-01-19T00:00:00,827,827,0,827
ΦΘΙΩΤΙΔΑΣ,804,61,0,8,61,2021-01-19T00:00:00,834,834,0,834
ΦΛΩΡΙΝΑΣ,304,30,0,10,30,2021-01-19T00:00:00,314,314,0,314
ΦΩΚΙΔΑΣ,805,48,0,42,48,2021-01-19T00:00:00,174,174,0,174
ΧΑΛΚΙΔΙΚΗΣ,207,30,0,15,30,2021-01-19T00:00:00,310,310,0,310
ΧΑΝΙΩΝ,1304,94,0,34,94,2021-01-19T00:00:00,1137,1137,0,1137
ΧΙΟΥ,1105,42,0,15,42,2021-01-19T00:00:00,329,329,0,329
ΑΙΤΩΛΟΑΚΑΡΝΑΝΙΑΣ,701,78,0,24,78,2021-01-20T00:00:00,1021,1021,0,1021
ΑΝΑΤΟΛΙΚΗΣ ΑΤΤΙΚΗΣ,901,276,40,184,316,2021-01-20T00:00:00,1090,1090,182,1272
ΑΝΔΡΟΥ,1201,0,0,0,0,2021-01-20T00:00:00,0,0,0,0
ΑΡΓΟΛΙΔΑΣ,1001,174,0,43,174,2021-01-20T00:00:00,681,681,0,681
ΑΡΚΑΔΙΑΣ,1002,108,0,60,108,2021-01-20T00:00:00,721,721,0,721
ΑΡΤΑΣ,401,132,0,102,132,2021-01-20T00:00:00,778,778,0,778
ΑΧΑΪΑΣ,702,439,95,282,534,2021-01-20T00:00:00,2991,2991,188,3179
ΒΟΙΩΤΙΑΣ,801,155,0,96,155,2021-01-20T00:00:00,625,625,0,625
ΒΟΡΕΙΟΥ ΤΟΜΕΑ ΑΘΗΝΩΝ,902,2191,0,908,2191,2021-01-20T00:00:00,16509,16509,0,16509
ΓΡΕΒΕΝΩΝ,301,36,0,2,36,2021-01-20T00:00:00,315,315,0,315
ΔΡΑΜΑΣ,101,168,0,108,168,2021-01-20T00:00:00,691,691,0,691
ΔΥΤΙΚΗΣ ΑΤΤΙΚΗΣ,903,122,53,99,175,2021-01-20T00:00:00,721,721,195,916
ΔΥΤΙΚΟΥ ΤΟΜΕΑ ΑΘΗΝΩΝ,904,444,40,229,484,2021-01-20T00:00:00,3519,3519,194,3713
ΕΒΡΟΥ,102,301,0,153,301,2021-01-20T00:00:00,1757,1757,0,1757
ΕΥΒΟΙΑΣ,802,434,0,234,434,2021-01-20T00:00:00,1360,1360,0,1360
ΕΥΡΥΤΑΝΙΑΣ,803,29,0,-7,29,2021-01-20T00:00:00,240,240,0,240
ΖΑΚΥΝΘΟΥ,601,102,0,42,102,2021-01-20T00:00:00,352,352,0,352
ΗΛΕΙΑΣ,703,198,0,65,198,2021-01-20T00:00:00,968,968,0,968
ΗΜΑΘΙΑΣ,201,135,0,75,135,2021-01-20T00:00:00,903,903,0,903
ΗΡΑΚΛΕΙΟΥ,1301,488,0,141,488,2021-01-20T00:00:00,3871,3871,0,3871
ΘΑΣΟΥ,103,0,0,0,0,2021-01-20T00:00:00,0,0,0,0
ΘΕΣΠΡΩΤΙΑΣ,402,96,0,17,96,2021-01-20T00:00:00,481,481,0,481
ΘΕΣΣΑΛΟΝΙΚΗΣ,202,1468,79,733,1547,2021-01-20T00:00:00,13571,13571,138,13709
ΘΗΡΑΣ,1202,18,0,-12,18,2021-01-20T00:00:00,83,83,0,83
ΙΘΑΚΗΣ,602,0,0,0,0,2021-01-20T00:00:00,0,0,0,0
ΙΚΑΡΙΑΣ,1101,17,0,-7,17,2021-01-20T00:00:00,81,81,0,81
ΙΩΑΝΝΙΝΩΝ,403,236,93,114,329,2021-01-20T00:00:00,3109,3109,169,3278
ΚΑΒΑΛΑΣ,104,148,0,88,148,2021-01-20T00:00:00,907,907,0,907
ΚΑΛΥΜΝΟΥ,1203,33,0,27,33,2021-01-20T00:00:00,184,184,0,184
ΚΑΡΔΙΤΣΑΣ,501,234,0,169,234,2021-01-20T00:00:00,943,943,0,943
ΚΑΡΠΑΘΟΥ,1204,12,0,12,12,2021-01-20T00:00:00,27,27,0,27
ΚΑΣΤΟΡΙΑΣ,302,59,0,29,59,2021-01-20T00:00:00,414,414,0,414
ΚΕΑΣ-ΚΥΘΝΟΥ,1205,0,0,0,0,2021-01-20T00:00:00,0,0,0,0
ΚΕΝΤΡΙΚΟΥ ΤΟΜΕΑ ΑΘΗΝΩΝ,905,1640,97,641,1737,2021-01-20T00:00:00,22254,22254,408,22662
ΚΕΡΚΥΡΑΣ,603,231,0,123,231,2021-01-20T00:00:00,659,659,0,659
ΚΕΦΑΛΛΗΝΙΑΣ,604,137,0,7,137,2021-01-20T00:00:00,507,507,0,507
ΚΙΛΚΙΣ,203,202,0,136,202,2021-01-20T00:00:00,648,648,0,648
ΚΟΖΑΝΗΣ,303,114,0,-7,114,2021-01-20T00:00:00,1019,1019,0,1019
ΚΟΡΙΝΘΙΑΣ,1003,71,0,41,71,2021-01-20T00:00:00,451,451,0,451
ΚΩ,1206,66,0,6,66,2021-01-20T00:00:00,259,259,0,259
ΛΑΚΩΝΙΑΣ,1004,156,0,19,156,2021-01-20T00:00:00,795,795,0,795
ΛΑΡΙΣΑΣ,502,211,95,108,306,2021-01-20T00:00:00,2315,2315,190,2505
ΛΑΣΙΘΙΟΥ,1302,253,0,59,253,2021-01-20T00:00:00,1046,1046,0,1046
ΛΕΣΒΟΥ,1102,151,0,-17,151,2021-01-20T00:00:00,603,603,0,603
ΛΕΥΚΑΔΑΣ,605,47,0,11,47,2021-01-20T00:00:00,218,218,0,218
ΛΗΜΝΟΥ,1103,42,0,-12,42,2021-01-20T00:00:00,269,269,0,269
ΜΑΓΝΗΣΙΑΣ,503,78,0,29,78,2021-01-20T00:00:00,760,760,0,760
ΜΕΣΣΗΝΙΑΣ,1005,175,0,70,175,2021-01-20T00:00:00,945,945,0,945
ΜΗΛΟΥ,1207,0,0,0,0,2021-01-20T00:00:00,0,0,0,0
ΜΥΚΟΝΟΥ,1208,0,0,0,0,2021-01-20T00:00:00,0,0,0,0
ΝΑΞΟΥ,1209,30,0,18,30,2021-01-20T00:00:00,102,102,0,102
ΝΗΣΩΝ,906,18,0,-6,18,2021-01-20T00:00:00,82,82,0,82
ΝΟΤΙΟΥ ΤΟΜΕΑ ΑΘΗΝΩΝ,907,272,0,170,272,2021-01-20T00:00:00,1714,1714,0,1714
ΞΑΝΘΗΣ,105,117,0,57,117,2021-01-20T00:00:00,787,787,0,787
ΠΑΡΟΥ,1210,0,0,0,0,2021-01-20T00:00:00,0,0,0,0
ΠΕΙΡΑΙΩΣ,908,636,0,409,636,2021-01-20T00:00:00,3828,3828,0,3828
ΠΕΛΛΑΣ,204,196,0,116,196,2021-01-20T00:00:00,880,880,0,880
ΠΙΕΡΙΑΣ,205,108,0,54,108,2021-01-20T00:00:00,630,630,0,630
ΠΡΕΒΕΖΑΣ,404,48,0,0,48,2021-01-20T00:00:00,459,459,0,459
ΡΕΘΥΜΝΟΥ,1303,150,0,120,150,2021-01-20T00:00:00,675,675,0,675
ΡΟΔΟΠΗΣ,106,90,0,42,90,2021-01-20T00:00:00,483,483,0,483
ΡΟΔΟΥ,1211,96,0,6,96,2021-01-20T00:00:00,621,621,0,621
ΣΑΜΟΥ,1104,48,0,18,48,2021-01-20T00:00:00,288,288,0,288
ΣΕΡΡΩΝ,206,126,0,54,126,2021-01-20T00:00:00,888,888,0,888
ΣΠΟΡΑΔΩΝ,504,0,0,0,0,2021-01-20T00:00:00,0,0,0,0
ΣΥΡΟΥ,1212,48,0,19,48,2021-01-20T00:00:00,247,247,0,247
ΤΗΝΟΥ,1213,0,0,0,0,2021-01-20T00:00:00,0,0,0,0
ΤΡΙΚΑΛΩΝ,505,179,0,107,179,2021-01-20T00:00:00,1006,1006,0,1006
ΦΘΙΩΤΙΔΑΣ,804,139,0,78,139,2021-01-20T00:00:00,973,973,0,973
ΦΛΩΡΙΝΑΣ,304,66,0,36,66,2021-01-20T00:00:00,380,380,0,380
ΦΩΚΙΔΑΣ,805,48,0,0,48,2021-01-20T00:00:00,222,222,0,222
ΧΑΛΚΙΔΙΚΗΣ,207,90,0,60,90,2021-01-20T00:00:00,400,400,0,400
ΧΑΝΙΩΝ,1304,345,0,251,345,2021-01-20T00:00:00,1482,1482,0,1482
ΧΙΟΥ,1105,30,0,-12,30,2021-01-20T00:00:00,359,359,0,359
ΑΙΤΩΛΟΑΚΑΡΝΑΝΙΑΣ,701,188,41,13,229,2021-02-04T00:00:00,2691,2691,728,3419
ΑΝΑΤΟΛΙΚΗΣ ΑΤΤΙΚΗΣ,901,531,2,23,533,2021-02-04T00:00:00,6773,6773,619,7392
ΑΝΔΡΟΥ,1201,13,0,-22,13,2021-02-04T00:00:00,252,252,0,252
ΑΡΓΟΛΙΔΑΣ,1001,167,0,0,167,2021-02-04T00:00:00,2411,2411,260,2671
ΑΡΚΑΔΙΑΣ,1002,160,1,0,161,2021-02-04T00:00:00,2315,2315,484,2799
ΑΡΤΑΣ,401,152,10,-25,162,2021-02-04T00:00:00,2392,2392,552,2944
ΑΧΑΪΑΣ,702,504,66,10,570,2021-02-04T00:00:00,8301,8301,1997,10298
ΒΟΙΩΤΙΑΣ,801,115,1,-5,116,2021-02-04T00:00:00,2226,2226,352,2578
ΒΟΡΕΙΟΥ ΤΟΜΕΑ ΑΘΗΝΩΝ,902,1624,1749,104,3373,2021-02-04T00:00:00,36209,36209,9757,45966
ΓΡΕΒΕΝΩΝ,301,54,0,0,54,2021-02-04T00:00:00,792,792,193,985
ΔΡΑΜΑΣ,101,153,1,4,154,2021-02-04T00:00:00,2328,2328,371,2699
ΔΥΤΙΚΗΣ ΑΤΤΙΚΗΣ,903,60,18,-19,78,2021-02-04T00:00:00,2856,2856,518,3374
ΔΥΤΙΚΟΥ ΤΟΜΕΑ ΑΘΗΝΩΝ,904,587,155,52,742,2021-02-04T00:00:00,11637,11637,2525,14162
ΕΒΡΟΥ,102,170,130,-6,300,2021-02-04T00:00:00,4263,4263,956,5219
ΕΥΒΟΙΑΣ,802,249,2,-52,251,2021-02-04T00:00:00,5115,5115,567,5682
ΕΥΡΥΤΑΝΙΑΣ,803,29,1,-12,30,2021-02-04T00:00:00,565,565,144,709
ΖΑΚΥΝΘΟΥ,601,14,40,0,54,2021-02-04T00:00:00,1168,1168,137,1305
ΗΛΕΙΑΣ,703,210,1,-7,211,2021-02-04T00:00:00,3197,3197,504,3701
ΗΜΑΘΙΑΣ,201,202,14,0,216,2021-02-04T00:00:00,2992,2992,594,3586
ΗΡΑΚΛΕΙΟΥ,1301,270,292,35,562,2021-02-04T00:00:00,8246,8246,1930,10176
ΘΑΣΟΥ,103,38,4,-6,42,2021-02-04T00:00:00,304,304,13,317
ΘΕΣΠΡΩΤΙΑΣ,402,108,0,-4,108,2021-02-04T00:00:00,1648,1648,221,1869
ΘΕΣΣΑΛΟΝΙΚΗΣ,202,1628,949,-189,2577,2021-02-04T00:00:00,31707,31707,9044,40751
ΘΗΡΑΣ,1202,6,0,-6,6,2021-02-04T00:00:00,304,304,19,323
ΙΘΑΚΗΣ,602,0,0,0,0,2021-02-04T00:00:00,0,0,0,0
ΙΚΑΡΙΑΣ,1101,6,0,-24,6,2021-02-04T00:00:00,357,357,30,387
ΙΩΑΝΝΙΝΩΝ,403,238,137,-74,375,2021-02-04T00:00:00,6278,6278,2397,8675
ΚΑΒΑΛΑΣ,104,205,11,-30,216,2021-02-04T00:00:00,3114,3114,567,3681
ΚΑΛΥΜΝΟΥ,1203,0,30,-64,30,2021-02-04T00:00:00,664,664,127,791
ΚΑΡΔΙΤΣΑΣ,501,219,2,-25,221,2021-02-04T00:00:00,3411,3411,537,3948
ΚΑΡΠΑΘΟΥ,1204,6,0,-12,6,2021-02-04T00:00:00,252,252,15,267
ΚΑΣΤΟΡΙΑΣ,302,66,35,-5,101,2021-02-04T00:00:00,1448,1448,282,1730
ΚΕΑΣ-ΚΥΘΝΟΥ,1205,0,0,0,0,2021-02-04T00:00:00,0,0,0,0
ΚΕΝΤΡΙΚΟΥ ΤΟΜΕΑ ΑΘΗΝΩΝ,905,2519,1250,-73,3769,2021-02-04T00:00:00,45025,45025,16459,61484
ΚΕΡΚΥΡΑΣ,603,73,0,-76,73,2021-02-04T00:00:00,2578,2578,196,2774
ΚΕΦΑΛΛΗΝΙΑΣ,604,54,0,-29,54,2021-02-04T00:00:00,1583,1583,173,1756
ΚΙΛΚΙΣ,203,114,0,-36,114,2021-02-04T00:00:00,2259,2259,304,2563
ΚΟΖΑΝΗΣ,303,207,21,24,228,2021-02-04T00:00:00,2965,2965,662,3627
ΚΟΡΙΝΘΙΑΣ,1003,162,0,0,162,2021-02-04T00:00:00,2122,2122,296,2418
ΚΩ,1206,7,40,-2,47,2021-02-04T00:00:00,915,915,86,1001
ΛΑΚΩΝΙΑΣ,1004,153,2,30,155,2021-02-04T00:00:00,2411,2411,367,2778
ΛΑΡΙΣΑΣ,502,367,5,-19,372,2021-02-04T00:00:00,5875,5875,1695,7570
ΛΑΣΙΘΙΟΥ,1302,136,49,-12,185,2021-02-04T00:00:00,3623,3623,499,4122
ΛΕΣΒΟΥ,1102,75,57,-24,132,2021-02-04T00:00:00,2258,2258,208,2466
ΛΕΥΚΑΔΑΣ,605,48,6,0,54,2021-02-04T00:00:00,851,851,100,951
ΛΗΜΝΟΥ,1103,4,50,-12,54,2021-02-04T00:00:00,653,653,155,808
ΜΑΓΝΗΣΙΑΣ,503,150,90,-19,240,2021-02-04T00:00:00,3377,3377,516,3893
ΜΕΣΣΗΝΙΑΣ,1005,262,10,20,272,2021-02-04T00:00:00,3848,3848,561,4409
ΜΗΛΟΥ,1207,23,0,1,23,2021-02-04T00:00:00,124,124,0,124
ΜΥΚΟΝΟΥ,1208,0,0,0,0,2021-02-04T00:00:00,144,144,0,144
ΝΑΞΟΥ,1209,9,9,-6,18,2021-02-04T00:00:00,419,419,43,462
ΝΗΣΩΝ,906,105,0,-16,105,2021-02-04T00:00:00,1320,1320,25,1345
ΝΟΤΙΟΥ ΤΟΜΕΑ ΑΘΗΝΩΝ,907,294,340,58,634,2021-02-04T00:00:00,5565,5565,733,6298
ΞΑΝΘΗΣ,105,115,5,-24,120,2021-02-04T00:00:00,1910,1910,498,2408
ΠΑΡΟΥ,1210,30,0,0,30,2021-02-04T00:00:00,258,258,0,258
ΠΕΙΡΑΙΩΣ,908,605,296,-53,901,2021-02-04T00:00:00,11303,11303,2417,13720
ΠΕΛΛΑΣ,204,307,0,2,307,2021-02-04T00:00:00,3682,3682,522,4204
ΠΙΕΡΙΑΣ,205,199,10,0,209,2021-02-04T00:00:00,2687,2687,389,3076
ΠΡΕΒΕΖΑΣ,404,53,0,-1,53,2021-02-04T00:00:00,959,959,318,1277
ΡΕΘΥΜΝΟΥ,1303,19,83,-48,102,2021-02-04T00:00:00,2206,2206,365,2571
ΡΟΔΟΠΗΣ,106,76,20,-24,96,2021-02-04T00:00:00,1510,1510,281,1791
ΡΟΔΟΥ,1211,4,116,-100,120,2021-02-04T00:00:00,1983,1983,325,2308
ΣΑΜΟΥ,1104,4,44,-6,48,2021-02-04T00:00:00,755,755,157,912
ΣΕΡΡΩΝ,206,117,57,-43,174,2021-02-04T00:00:00,2335,2335,595,2930
ΣΠΟΡΑΔΩΝ,504,0,0,-6,0,2021-02-04T00:00:00,201,201,3,204
ΣΥΡΟΥ,1212,3,51,0,54,2021-02-04T00:00:00,700,700,147,847
ΤΗΝΟΥ,1213,18,0,-12,18,2021-02-04T00:00:00,262,262,1,263
ΤΡΙΚΑΛΩΝ,505,221,1,7,222,2021-02-04T00:00:00,3301,3301,634,3935
ΦΘΙΩΤΙΔΑΣ,804,28,104,-7,132,2021-02-04T00:00:00,2767,2767,624,3391
ΦΛΩΡΙΝΑΣ,304,101,0,-1,101,2021-02-04T00:00:00,1411,1411,242,1653
ΦΩΚΙΔΑΣ,805,54,1,3,55,2021-02-04T00:00:00,811,811,104,915
ΧΑΛΚΙΔΙΚΗΣ,207,90,0,-28,90,2021-02-04T00:00:00,1745,1745,249,1994
ΧΑΝΙΩΝ,1304,336,6,-21,342,2021-02-04T00:00:00,5392,5392,922,6314
ΧΙΟΥ,1105,42,30,6,72,2021-02-04T00:00:00,950,950,153,1103
ΑΙΤΩΛΟΑΚΑΡΝΑΝΙΑΣ,701,189,45,5,234,2021-02-05T00:00:00,2880,2880,773,3653
ΑΝΑΤΟΛΙΚΗΣ ΑΤΤΙΚΗΣ,901,526,2,-5,528,2021-02-05T00:00:00,7299,7299,621,7920
ΑΝΔΡΟΥ,1201,5,1,-7,6,2021-02-05T00:00:00,257,257,1,258
ΑΡΓΟΛΙΔΑΣ,1001,161,0,-6,161,2021-02-05T00:00:00,2572,2572,260,2832
ΑΡΚΑΔΙΑΣ,1002,142,2,-17,144,2021-02-05T00:00:00,2457,2457,486,2943
ΑΡΤΑΣ,401,148,2,-12,150,2021-02-05T00:00:00,2540,2540,554,3094
ΑΧΑΪΑΣ,702,445,68,-57,513,2021-02-05T00:00:00,8746,8746,2065,10811
ΒΟΙΩΤΙΑΣ,801,103,0,-13,103,2021-02-05T00:00:00,2329,2329,352,2681
ΒΟΡΕΙΟΥ ΤΟΜΕΑ ΑΘΗΝΩΝ,902,1503,1790,-80,3293,2021-02-05T00:00:00,37712,37712,11547,49259
ΓΡΕΒΕΝΩΝ,301,54,0,0,54,2021-02-05T00:00:00,846,846,193,1039
ΔΡΑΜΑΣ,101,156,0,2,156,2021-02-05T00:00:00,2484,2484,371,2855
ΔΥΤΙΚΗΣ ΑΤΤΙΚΗΣ,903,39,21,-18,60,2021-02-05T00:00:00,2895,2895,539,3434
ΔΥΤΙΚΟΥ ΤΟΜΕΑ ΑΘΗΝΩΝ,904,588,121,-33,709,2021-02-05T00:00:00,12225,12225,2646,14871
ΕΒΡΟΥ,102,172,121,-7,293,2021-02-05T00:00:00,4435,4435,1077,5512
ΕΥΒΟΙΑΣ,802,214,0,-37,214,2021-02-05T00:00:00,5329,5329,567,5896
ΕΥΡΥΤΑΝΙΑΣ,803,30,0,0,30,2021-02-05T00:00:00,595,595,144,739
ΖΑΚΥΝΘΟΥ,601,59,2,7,61,2021-02-05T00:00:00,1227,1227,139,1366
ΗΛΕΙΑΣ,703,166,1,-44,167,2021-02-05T00:00:00,3363,3363,505,3868
ΗΜΑΘΙΑΣ,201,235,15,34,250,2021-02-05T00:00:00,3227,3227,609,3836
ΗΡΑΚΛΕΙΟΥ,1301,283,250,-29,533,2021-02-05T00:00:00,8529,8529,2180,10709
ΘΑΣΟΥ,103,30,0,-12,30,2021-02-05T00:00:00,334,334,13,347
ΘΕΣΠΡΩΤΙΑΣ,402,102,0,-6,102,2021-02-05T00:00:00,1750,1750,221,1971
ΘΕΣΣΑΛΟΝΙΚΗΣ,202,1603,869,-105,2472,2021-02-05T00:00:00,33310,33310,9913,43223
ΘΗΡΑΣ,1202,5,1,0,6,2021-02-05T00:00:00,309,309,20,329
ΙΘΑΚΗΣ,602,0,0,0,0,2021-02-05T00:00:00,0,0,0,0
ΙΚΑΡΙΑΣ,1101,156,0,150,156,2021-02-05T00:00:00,513,513,30,543
ΙΩΑΝΝΙΝΩΝ,403,263,114,2,377,2021-02-05T00:00:00,6541,6541,2511,9052
ΚΑΒΑΛΑΣ,104,204,1,-11,205,2021-02-05T00:00:00,3318,3318,568,3886
ΚΑΛΥΜΝΟΥ,1203,12,0,-18,12,2021-02-05T00:00:00,676,676,127,803
ΚΑΡΔΙΤΣΑΣ,501,168,0,-53,168,2021-02-05T00:00:00,3579,3579,537,4116
ΚΑΡΠΑΘΟΥ,1204,0,0,-6,0,2021-02-05T00:00:00,252,252,15,267
ΚΑΣΤΟΡΙΑΣ,302,108,0,7,108,2021-02-05T00:00:00,1556,1556,282,1838
ΚΕΑΣ-ΚΥΘΝΟΥ,1205,0,0,0,0,2021-02-05T00:00:00,0,0,0,0
ΚΕΝΤΡΙΚΟΥ ΤΟΜΕΑ ΑΘΗΝΩΝ,905,2492,787,-490,3279,2021-02-05T00:00:00,47517,47517,17246,64763
ΚΕΡΚΥΡΑΣ,603,131,0,58,131,2021-02-05T00:00:00,2709,2709,196,2905
ΚΕΦΑΛΛΗΝΙΑΣ,604,26,0,-28,26,2021-02-05T00:00:00,1609,1609,173,1782
ΚΙΛΚΙΣ,203,84,0,-30,84,2021-02-05T00:00:00,2343,2343,304,2647
ΚΟΖΑΝΗΣ,303,191,37,0,228,2021-02-05T00:00:00,3156,3156,699,3855
ΚΟΡΙΝΘΙΑΣ,1003,154,2,-6,156,2021-02-05T00:00:00,2276,2276,298,2574
ΚΩ,1206,4,2,-41,6,2021-02-05T00:00:00,919,919,88,1007
ΛΑΚΩΝΙΑΣ,1004,157,1,3,158,2021-02-05T00:00:00,2568,2568,368,2936
ΛΑΡΙΣΑΣ,502,349,11,-12,360,2021-02-05T00:00:00,6224,6224,1706,7930
ΛΑΣΙΘΙΟΥ,1302,114,16,-55,130,2021-02-05T00:00:00,3737,3737,515,4252
ΛΕΣΒΟΥ,1102,118,1,-13,119,2021-02-05T00:00:00,2376,2376,209,2585
ΛΕΥΚΑΔΑΣ,605,54,0,0,54,2021-02-05T00:00:00,905,905,100,1005
ΛΗΜΝΟΥ,1103,41,1,-12,42,2021-02-05T00:00:00,694,694,156,850
ΜΑΓΝΗΣΙΑΣ,503,177,70,7,247,2021-02-05T00:00:00,3554,3554,586,4140
ΜΕΣΣΗΝΙΑΣ,1005,257,2,-13,259,2021-02-05T00:00:00,4105,4105,563,4668
ΜΗΛΟΥ,1207,23,2,2,25,2021-02-05T00:00:00,147,147,2,149
ΜΥΚΟΝΟΥ,1208,0,0,0,0,2021-02-05T00:00:00,144,144,0,144
ΝΑΞΟΥ,1209,6,0,-12,6,2021-02-05T00:00:00,425,425,43,468
ΝΗΣΩΝ,906,96,0,-9,96,2021-02-05T00:00:00,1416,1416,25,1441
ΝΟΤΙΟΥ ΤΟΜΕΑ ΑΘΗΝΩΝ,907,301,287,-46,588,2021-02-05T00:00:00,5866,5866,1020,6886
ΞΑΝΘΗΣ,105,95,6,-19,101,2021-02-05T00:00:00,2005,2005,504,2509
ΠΑΡΟΥ,1210,10,2,-18,12,2021-02-05T00:00:00,268,268,2,270
ΠΕΙΡΑΙΩΣ,908,687,248,34,935,2021-02-05T00:00:00,11990,11990,2665,14655
ΠΕΛΛΑΣ,204,288,1,-18,289,2021-02-05T00:00:00,3970,3970,523,4493
ΠΙΕΡΙΑΣ,205,202,10,3,212,2021-02-05T00:00:00,2889,2889,399,3288
ΠΡΕΒΕΖΑΣ,404,53,0,0,53,2021-02-05T00:00:00,1012,1012,318,1330
ΡΕΘΥΜΝΟΥ,1303,38,76,12,114,2021-02-05T00:00:00,2244,2244,441,2685
ΡΟΔΟΠΗΣ,106,70,8,-18,78,2021-02-05T00:00:00,1580,1580,289,1869
ΡΟΔΟΥ,1211,11,96,-13,107,2021-02-05T00:00:00,1994,1994,421,2415
ΣΑΜΟΥ,1104,24,30,6,54,2021-02-05T00:00:00,779,779,187,966
ΣΕΡΡΩΝ,206,148,8,-18,156,2021-02-05T00:00:00,2483,2483,603,3086
ΣΠΟΡΑΔΩΝ,504,0,0,0,0,2021-02-05T00:00:00,201,201,3,204
ΣΥΡΟΥ,1212,33,15,-6,48,2021-02-05T00:00:00,733,733,162,895
ΤΗΝΟΥ,1213,6,0,-12,6,2021-02-05T00:00:00,268,268,1,269
ΤΡΙΚΑΛΩΝ,505,204,0,-18,204,2021-02-05T00:00:00,3505,3505,634,4139
ΦΘΙΩΤΙΔΑΣ,804,97,41,6,138,2021-02-05T00:00:00,2864,2864,665,3529
ΦΛΩΡΙΝΑΣ,304,77,0,-24,77,2021-02-05T00:00:00,1488,1488,242,1730
ΦΩΚΙΔΑΣ,805,48,0,-7,48,2021-02-05T00:00:00,859,859,104,963
ΧΑΛΚΙΔΙΚΗΣ,207,77,0,-13,77,2021-02-05T00:00:00,1822,1822,249,2071
ΧΑΝΙΩΝ,1304,329,2,-11,331,2021-02-05T00:00:00,5721,5721,924,6645
ΧΙΟΥ,1105,41,43,12,84,2021-02-05T00:00:00,991,991,196,1187
ΑΙΤΩΛΟΑΚΑΡΝΑΝΙΑΣ,701,148,68,-18,216,2021-02-06T00:00:00,3028,3028,841,3869
ΑΝΑΤΟΛΙΚΗΣ ΑΤΤΙΚΗΣ,901,505,19,-4,524,2021-02-06T00:00:00,7804,7804,640,8444
ΑΝΔΡΟΥ,1201,6,0,0,6,2021-02-06T00:00:00,263,263,1,264
ΑΡΓΟΛΙΔΑΣ,1001,85,65,-11,150,2021-02-06T00:00:00,2657,2657,325,2982
ΑΡΚΑΔΙΑΣ,1002,114,31,1,145,2021-02-06T00:00:00,2571,2571,517,3088
ΑΡΤΑΣ,401,125,25,0,150,2021-02-06T00:00:00,2665,2665,579,3244
ΑΧΑΪΑΣ,702,314,116,-83,430,2021-02-06T00:00:00,9060,9060,2181,11241
ΒΟΙΩΤΙΑΣ,801,101,17,15,118,2021-02-06T00:00:00,2430,2430,369,2799
ΒΟΡΕΙΟΥ ΤΟΜΕΑ ΑΘΗΝΩΝ,902,924,1097,-1272,2021,2021-02-06T00:00:00,38636,38636,12644,51280
ΓΡΕΒΕΝΩΝ,301,28,20,-6,48,2021-02-06T00:00:00,874,874,213,1087
ΔΡΑΜΑΣ,101,96,48,-12,144,2021-02-06T00:00:00,2580,2580,419,2999
ΔΥΤΙΚΗΣ ΑΤΤΙΚΗΣ,903,34,14,-12,48,2021-02-06T00:00:00,2929,2929,553,3482
ΔΥΤΙΚΟΥ ΤΟΜΕΑ ΑΘΗΝΩΝ,904,668,124,83,792,2021-02-06T00:00:00,12893,12893,2770,15663
ΕΒΡΟΥ,102,153,105,-35,258,2021-02-06T00:00:00,4588,4588,1182,5770
ΕΥΒΟΙΑΣ,802,147,49,-18,196,2021-02-06T00:00:00,5476,5476,616,6092
ΕΥΡΥΤΑΝΙΑΣ,803,21,15,6,36,2021-02-06T00:00:00,616,616,159,775
ΖΑΚΥΝΘΟΥ,601,25,29,-7,54,2021-02-06T00:00:00,1252,1252,168,1420
ΗΛΕΙΑΣ,703,97,49,-21,146,2021-02-06T00:00:00,3460,3460,554,4014
ΗΜΑΘΙΑΣ,201,185,37,-28,222,2021-02-06T00:00:00,3412,3412,646,4058
ΗΡΑΚΛΕΙΟΥ,1301,174,334,-25,508,2021-02-06T00:00:00,8703,8703,2514,11217
ΘΑΣΟΥ,103,30,0,0,30,2021-02-06T00:00:00,364,364,13,377
ΘΕΣΠΡΩΤΙΑΣ,402,52,50,0,102,2021-02-06T00:00:00,1802,1802,271,2073
ΘΕΣΣΑΛΟΝΙΚΗΣ,202,1318,695,-459,2013,2021-02-06T00:00:00,34628,34628,10608,45236
ΘΗΡΑΣ,1202,2,10,6,12,2021-02-06T00:00:00,311,311,30,341
ΙΘΑΚΗΣ,602,0,0,0,0,2021-02-06T00:00:00,0,0,0,0
ΙΚΑΡΙΑΣ,1101,168,5,17,173,2021-02-06T00:00:00,681,681,35,716
ΙΩΑΝΝΙΝΩΝ,403,241,138,2,379,2021-02-06T00:00:00,6782,6782,2649,9431
ΚΑΒΑΛΑΣ,104,155,55,5,210,2021-02-06T00:00:00,3473,3473,623,4096
ΚΑΛΥΜΝΟΥ,1203,1,5,-6,6,2021-02-06T00:00:00,677,677,132,809
ΚΑΡΔΙΤΣΑΣ,501,99,45,-24,144,2021-02-06T00:00:00,3678,3678,582,4260
ΚΑΡΠΑΘΟΥ,1204,0,0,0,0,2021-02-06T00:00:00,252,252,15,267
ΚΑΣΤΟΡΙΑΣ,302,70,21,-17,91,2021-02-06T00:00:00,1626,1626,303,1929
ΚΕΑΣ-ΚΥΘΝΟΥ,1205,0,0,0,0,2021-02-06T00:00:00,0,0,0,0
ΚΕΝΤΡΙΚΟΥ ΤΟΜΕΑ ΑΘΗΝΩΝ,905,1804,1321,-154,3125,2021-02-06T00:00:00,49321,49321,18567,67888
ΚΕΡΚΥΡΑΣ,603,104,53,26,157,2021-02-06T00:00:00,2813,2813,249,3062
ΚΕΦΑΛΛΗΝΙΑΣ,604,3,42,19,45,2021-02-06T00:00:00,1612,1612,215,1827
ΚΙΛΚΙΣ,203,43,35,-6,78,2021-02-06T00:00:00,2386,2386,339,2725
ΚΟΖΑΝΗΣ,303,173,38,-17,211,2021-02-06T00:00:00,3329,3329,737,4066
ΚΟΡΙΝΘΙΑΣ,1003,138,18,0,156,2021-02-06T00:00:00,2414,2414,316,2730
ΚΩ,1206,1,17,12,18,2021-02-06T00:00:00,920,920,105,1025
ΛΑΚΩΝΙΑΣ,1004,126,30,-2,156,2021-02-06T00:00:00,2694,2694,398,3092
ΛΑΡΙΣΑΣ,502,235,119,-6,354,2021-02-06T00:00:00,6459,6459,1825,8284
ΛΑΣΙΘΙΟΥ,1302,63,39,-28,102,2021-02-06T00:00:00,3800,3800,554,4354
ΛΕΣΒΟΥ,1102,91,35,7,126,2021-02-06T00:00:00,2467,2467,244,2711
ΛΕΥΚΑΔΑΣ,605,39,15,0,54,2021-02-06T00:00:00,944,944,115,1059
ΛΗΜΝΟΥ,1103,25,5,-12,30,2021-02-06T00:00:00,719,719,161,880
ΜΑΓΝΗΣΙΑΣ,503,168,78,-1,246,2021-02-06T00:00:00,3722,3722,664,4386
ΜΕΣΣΗΝΙΑΣ,1005,213,45,-1,258,2021-02-06T00:00:00,4318,4318,608,4926
ΜΗΛΟΥ,1207,6,0,-19,6,2021-02-06T00:00:00,153,153,2,155
ΜΥΚΟΝΟΥ,1208,0,0,0,0,2021-02-06T00:00:00,144,144,0,144
ΝΑΞΟΥ,1209,1,5,0,6,2021-02-06T00:00:00,426,426,48,474
ΝΗΣΩΝ,906,68,15,-13,83,2021-02-06T00:00:00,1484,1484,40,1524
ΝΟΤΙΟΥ ΤΟΜΕΑ ΑΘΗΝΩΝ,907,217,251,-120,468,2021-02-06T00:00:00,6083,6083,1271,7354
ΞΑΝΘΗΣ,105,52,44,-5,96,2021-02-06T00:00:00,2057,2057,548,2605
ΠΑΡΟΥ,1210,6,0,-6,6,2021-02-06T00:00:00,274,274,2,276
ΠΕΙΡΑΙΩΣ,908,525,141,-269,666,2021-02-06T00:00:00,12515,12515,2806,15321
ΠΕΛΛΑΣ,204,235,30,-24,265,2021-02-06T00:00:00,4205,4205,553,4758
ΠΙΕΡΙΑΣ,205,175,29,-8,204,2021-02-06T00:00:00,3064,3064,428,3492
ΠΡΕΒΕΖΑΣ,404,28,20,-5,48,2021-02-06T00:00:00,1040,1040,338,1378
ΡΕΘΥΜΝΟΥ,1303,37,23,-54,60,2021-02-06T00:00:00,2281,2281,464,2745
ΡΟΔΟΠΗΣ,106,46,26,-6,72,2021-02-06T00:00:00,1626,1626,315,1941
ΡΟΔΟΥ,1211,102,1,-4,103,2021-02-06T00:00:00,2096,2096,422,2518
ΣΑΜΟΥ,1104,33,9,-12,42,2021-02-06T00:00:00,812,812,196,1008
ΣΕΡΡΩΝ,206,116,40,0,156,2021-02-06T00:00:00,2599,2599,643,3242
ΣΠΟΡΑΔΩΝ,504,0,0,0,0,2021-02-06T00:00:00,201,201,3,204
ΣΥΡΟΥ,1212,48,0,0,48,2021-02-06T00:00:00,781,781,162,943
ΤΗΝΟΥ,1213,12,0,6,12,2021-02-06T00:00:00,280,280,1,281
ΤΡΙΚΑΛΩΝ,505,160,45,1,205,2021-02-06T00:00:00,3665,3665,679,4344
ΦΘΙΩΤΙΔΑΣ,804,73,41,-24,114,2021-02-06T00:00:00,2937,2937,706,3643
ΦΛΩΡΙΝΑΣ,304,35,21,-21,56,2021-02-06T00:00:00,1523,1523,263,1786
ΦΩΚΙΔΑΣ,805,39,15,6,54,2021-02-06T00:00:00,898,898,119,1017
ΧΑΛΚΙΔΙΚΗΣ,207,41,19,-17,60,2021-02-06T00:00:00,1863,1863,268,2131
ΧΑΝΙΩΝ,1304,266,53,-12,319,2021-02-06T00:00:00,5987,5987,977,6964
ΧΙΟΥ,1105,23,61,0,84,2021-02-06T00:00:00,1014,1014,257,1271
ΑΙΤΩΛΟΑΚΑΡΝΑΝΙΑΣ,701,181,42,7,223,2021-02-08T00:00:00,3209,3209,883,4092
ΑΝΑΤΟΛΙΚΗΣ ΑΤΤΙΚΗΣ,901,471,41,-12,512,2021-02-08T00:00:00,8275,8275,681,8956
ΑΝΔΡΟΥ,1201,0,0,-6,0,2021-02-08T00:00:00,263,263,1,264
ΑΡΓΟΛΙΔΑΣ,1001,104,63,17,167,2021-02-08T00:00:00,2761,2761,388,3149
ΑΡΚΑΔΙΑΣ,1002,94,38,-13,132,2021-02-08T00:00:00,2665,2665,555,3220
ΑΡΤΑΣ,401,125,25,0,150,2021-02-08T00:00:00,2790,2790,604,3394
ΑΧΑΪΑΣ,702,223,202,-5,425,2021-02-08T00:00:00,9283,9283,2383,11666
ΒΟΙΩΤΙΑΣ,801,98,39,19,137,2021-02-08T00:00:00,2528,2528,408,2936
ΒΟΡΕΙΟΥ ΤΟΜΕΑ ΑΘΗΝΩΝ,902,1334,676,-11,2010,2021-02-08T00:00:00,39970,39970,13320,53290
ΓΡΕΒΕΝΩΝ,301,69,27,48,96,2021-02-08T00:00:00,943,943,240,1183
ΔΡΑΜΑΣ,101,189,39,84,228,2021-02-08T00:00:00,2769,2769,458,3227
ΔΥΤΙΚΗΣ ΑΤΤΙΚΗΣ,903,21,15,-12,36,2021-02-08T00:00:00,2950,2950,568,3518
ΔΥΤΙΚΟΥ ΤΟΜΕΑ ΑΘΗΝΩΝ,904,1077,52,337,1129,2021-02-08T00:00:00,13970,13970,2822,16792
ΕΒΡΟΥ,102,192,115,49,307,2021-02-08T00:00:00,4780,4780,1297,6077
ΕΥΒΟΙΑΣ,802,98,118,20,216,2021-02-08T00:00:00,5574,5574,734,6308
ΕΥΡΥΤΑΝΙΑΣ,803,14,14,-8,28,2021-02-08T00:00:00,630,630,173,803
ΖΑΚΥΝΘΟΥ,601,28,20,-6,48,2021-02-08T00:00:00,1280,1280,188,1468
ΗΛΕΙΑΣ,703,75,72,1,147,2021-02-08T00:00:00,3535,3535,626,4161
ΗΜΑΘΙΑΣ,201,206,60,44,266,2021-02-08T00:00:00,3618,3618,706,4324
ΗΡΑΚΛΕΙΟΥ,1301,181,307,-20,488,2021-02-08T00:00:00,8884,8884,2821,11705
ΘΑΣΟΥ,103,24,0,-6,24,2021-02-08T00:00:00,388,388,13,401
ΘΕΣΠΡΩΤΙΑΣ,402,164,29,91,193,2021-02-08T00:00:00,1966,1966,300,2266
ΘΕΣΣΑΛΟΝΙΚΗΣ,202,1638,638,263,2276,2021-02-08T00:00:00,36266,36266,11246,47512
ΘΗΡΑΣ,1202,7,5,0,12,2021-02-08T00:00:00,318,318,35,353
ΙΘΑΚΗΣ,602,0,0,0,0,2021-02-08T00:00:00,0,0,0,0
ΙΚΑΡΙΑΣ,1101,0,5,-168,5,2021-02-08T00:00:00,681,681,40,721
ΙΩΑΝΝΙΝΩΝ,403,220,158,-1,378,2021-02-08T00:00:00,7002,7002,2807,9809
ΚΑΒΑΛΑΣ,104,203,60,53,263,2021-02-08T00:00:00,3676,3676,683,4359
ΚΑΛΥΜΝΟΥ,1203,3,9,6,12,2021-02-08T00:00:00,680,680,141,821
ΚΑΡΔΙΤΣΑΣ,501,102,54,12,156,2021-02-08T00:00:00,3780,3780,636,4416
ΚΑΡΠΑΘΟΥ,1204,0,0,0,0,2021-02-08T00:00:00,252,252,15,267
ΚΑΣΤΟΡΙΑΣ,302,114,31,54,145,2021-02-08T00:00:00,1740,1740,334,2074
ΚΕΑΣ-ΚΥΘΝΟΥ,1205,0,0,0,0,2021-02-08T00:00:00,0,0,0,0
ΚΕΝΤΡΙΚΟΥ ΤΟΜΕΑ ΑΘΗΝΩΝ,905,2529,686,90,3215,2021-02-08T00:00:00,51850,51850,19253,71103
ΚΕΡΚΥΡΑΣ,603,96,66,5,162,2021-02-08T00:00:00,2909,2909,315,3224
ΚΕΦΑΛΛΗΝΙΑΣ,604,12,24,-9,36,2021-02-08T00:00:00,1624,1624,239,1863
ΚΙΛΚΙΣ,203,142,38,102,180,2021-02-08T00:00:00,2528,2528,377,2905
ΚΟΖΑΝΗΣ,303,261,45,95,306,2021-02-08T00:00:00,3590,3590,782,4372
ΚΟΡΙΝΘΙΑΣ,1003,150,30,24,180,2021-02-08T00:00:00,2564,2564,346,2910
ΚΩ,1206,2,22,6,24,2021-02-08T00:00:00,922,922,127,1049
ΛΑΚΩΝΙΑΣ,1004,88,69,1,157,2021-02-08T00:00:00,2782,2782,467,3249
ΛΑΡΙΣΑΣ,502,247,155,48,402,2021-02-08T00:00:00,6706,6706,1980,8686
ΛΑΣΙΘΙΟΥ,1302,56,40,-6,96,2021-02-08T00:00:00,3856,3856,594,4450
ΛΕΣΒΟΥ,1102,67,35,-24,102,2021-02-08T00:00:00,2534,2534,279,2813
ΛΕΥΚΑΔΑΣ,605,36,18,0,54,2021-02-08T00:00:00,980,980,133,1113
ΛΗΜΝΟΥ,1103,20,4,-6,24,2021-02-08T00:00:00,739,739,165,904
ΜΑΓΝΗΣΙΑΣ,503,175,11,-60,186,2021-02-08T00:00:00,3897,3897,675,4572
ΜΕΣΣΗΝΙΑΣ,1005,221,57,20,278,2021-02-08T00:00:00,4539,4539,665,5204
ΜΗΛΟΥ,1207,35,0,29,35,2021-02-08T00:00:00,188,188,2,190
ΜΥΚΟΝΟΥ,1208,0,0,0,0,2021-02-08T00:00:00,144,144,0,144
ΝΑΞΟΥ,1209,1,11,6,12,2021-02-08T00:00:00,427,427,59,486
ΝΗΣΩΝ,906,54,0,-29,54,2021-02-08T00:00:00,1538,1538,40,1578
ΝΟΤΙΟΥ ΤΟΜΕΑ ΑΘΗΝΩΝ,907,402,71,5,473,2021-02-08T00:00:00,6485,6485,1342,7827
ΞΑΝΘΗΣ,105,100,56,60,156,2021-02-08T00:00:00,2157,2157,604,2761
ΠΑΡΟΥ,1210,6,0,0,6,2021-02-08T00:00:00,280,280,2,282
ΠΕΙΡΑΙΩΣ,908,726,116,176,842,2021-02-08T00:00:00,13241,13241,2922,16163
ΠΕΛΛΑΣ,204,299,53,87,352,2021-02-08T00:00:00,4504,4504,606,5110
ΠΙΕΡΙΑΣ,205,187,35,18,222,2021-02-08T00:00:00,3251,3251,463,3714
ΠΡΕΒΕΖΑΣ,404,32,28,12,60,2021-02-08T00:00:00,1072,1072,366,1438
ΡΕΘΥΜΝΟΥ,1303,35,22,-3,57,2021-02-08T00:00:00,2316,2316,486,2802
ΡΟΔΟΠΗΣ,106,97,23,48,120,2021-02-08T00:00:00,1723,1723,338,2061
ΡΟΔΟΥ,1211,150,0,47,150,2021-02-08T00:00:00,2246,2246,422,2668
ΣΑΜΟΥ,1104,37,11,6,48,2021-02-08T00:00:00,849,849,207,1056
ΣΕΡΡΩΝ,206,193,41,78,234,2021-02-08T00:00:00,2792,2792,684,3476
ΣΠΟΡΑΔΩΝ,504,0,0,0,0,2021-02-08T00:00:00,201,201,3,204
ΣΥΡΟΥ,1212,54,0,6,54,2021-02-08T00:00:00,835,835,162,997
ΤΗΝΟΥ,1213,0,0,-12,0,2021-02-08T00:00:00,280,280,1,281
ΤΡΙΚΑΛΩΝ,505,233,73,101,306,2021-02-08T00:00:00,3898,3898,752,4650
ΦΘΙΩΤΙΔΑΣ,804,113,55,54,168,2021-02-08T00:00:00,3050,3050,761,3811
ΦΛΩΡΙΝΑΣ,304,46,19,9,65,2021-02-08T00:00:00,1569,1569,282,1851
ΦΩΚΙΔΑΣ,805,56,10,12,66,2021-02-08T00:00:00,954,954,129,1083
ΧΑΛΚΙΔΙΚΗΣ,207,170,28,138,198,2021-02-08T00:00:00,2033,2033,296,2329
ΧΑΝΙΩΝ,1304,262,61,4,323,2021-02-08T00:00:00,6249,6249,1038,7287
ΧΙΟΥ,1105,70,26,12,96,2021-02-08T00:00:00,1084,1084,283,1367
ΑΙΤΩΛΟΑΚΑΡΝΑΝΙΑΣ,701,144,52,-27,196,2021-02-09T00:00:00,3353,3353,935,4288
ΑΝΑΤΟΛΙΚΗΣ ΑΤΤΙΚΗΣ,901,487,46,21,533,2021-02-09T00:00:00,8762,8762,727,9489
ΑΝΔΡΟΥ,1201,0,0,0,0,2021-02-09T00:00:00,263,263,1,264
ΑΡΓΟΛΙΔΑΣ,1001,33,131,-3,164,2021-02-09T00:00:00,2794,2794,519,3313
ΑΡΚΑΔΙΑΣ,1002,56,46,-30,102,2021-02-09T00:00:00,2721,2721,601,3322
ΑΡΤΑΣ,401,130,29,9,159,2021-02-09T00:00:00,2920,2920,633,3553
ΑΧΑΪΑΣ,702,128,174,-123,302,2021-02-09T00:00:00,9411,9411,2557,11968
ΒΟΙΩΤΙΑΣ,801,53,57,-27,110,2021-02-09T00:00:00,2581,2581,465,3046
ΒΟΡΕΙΟΥ ΤΟΜΕΑ ΑΘΗΝΩΝ,902,1124,1341,455,2465,2021-02-09T00:00:00,41094,41094,14661,55755
ΓΡΕΒΕΝΩΝ,301,73,41,18,114,2021-02-09T00:00:00,1016,1016,281,1297
ΔΡΑΜΑΣ,101,139,59,-30,198,2021-02-09T00:00:00,2908,2908,517,3425
ΔΥΤΙΚΗΣ ΑΤΤΙΚΗΣ,903,5,19,-12,24,2021-02-09T00:00:00,2955,2955,587,3542
ΔΥΤΙΚΟΥ ΤΟΜΕΑ ΑΘΗΝΩΝ,904,1079,212,162,1291,2021-02-09T00:00:00,15049,15049,3034,18083
ΕΒΡΟΥ,102,163,143,-1,306,2021-02-09T00:00:00,4943,4943,1440,6383
ΕΥΒΟΙΑΣ,802,60,203,47,263,2021-02-09T00:00:00,5634,5634,937,6571
ΕΥΡΥΤΑΝΙΑΣ,803,8,36,16,44,2021-02-09T00:00:00,638,638,209,847
ΖΑΚΥΝΘΟΥ,601,9,51,12,60,2021-02-09T00:00:00,1289,1289,239,1528
ΗΛΕΙΑΣ,703,53,125,31,178,2021-02-09T00:00:00,3588,3588,751,4339
ΗΜΑΘΙΑΣ,201,205,60,-1,265,2021-02-09T00:00:00,3823,3823,766,4589
ΗΡΑΚΛΕΙΟΥ,1301,87,332,-69,419,2021-02-09T00:00:00,8971,8971,3153,12124
ΘΑΣΟΥ,103,12,0,-12,12,2021-02-09T00:00:00,400,400,13,413
ΘΕΣΠΡΩΤΙΑΣ,402,79,83,-31,162,2021-02-09T00:00:00,2045,2045,383,2428
ΘΕΣΣΑΛΟΝΙΚΗΣ,202,1396,731,-149,2127,2021-02-09T00:00:00,37662,37662,11977,49639
ΘΗΡΑΣ,1202,0,30,18,30,2021-02-09T00:00:00,318,318,65,383
ΙΘΑΚΗΣ,602,0,0,0,0,2021-02-09T00:00:00,0,0,0,0
ΙΚΑΡΙΑΣ,1101,1,22,18,23,2021-02-09T00:00:00,682,682,62,744
ΙΩΑΝΝΙΝΩΝ,403,201,137,-40,338,2021-02-09T00:00:00,7203,7203,2944,10147
ΚΑΒΑΛΑΣ,104,191,61,-11,252,2021-02-09T00:00:00,3867,3867,744,4611
ΚΑΛΥΜΝΟΥ,1203,1,5,-6,6,2021-02-09T00:00:00,681,681,146,827
ΚΑΡΔΙΤΣΑΣ,501,57,63,-36,120,2021-02-09T00:00:00,3837,3837,699,4536
ΚΑΡΠΑΘΟΥ,1204,0,0,0,0,2021-02-09T00:00:00,252,252,15,267
ΚΑΣΤΟΡΙΑΣ,302,114,35,4,149,2021-02-09T00:00:00,1854,1854,369,2223
ΚΕΑΣ-ΚΥΘΝΟΥ,1205,0,0,0,0,2021-02-09T00:00:00,0,0,0,0
ΚΕΝΤΡΙΚΟΥ ΤΟΜΕΑ ΑΘΗΝΩΝ,905,2383,949,117,3332,2021-02-09T00:00:00,54233,54233,20202,74435
ΚΕΡΚΥΡΑΣ,603,100,103,41,203,2021-02-09T00:00:00,3009,3009,418,3427
ΚΕΦΑΛΛΗΝΙΑΣ,604,1,125,90,126,2021-02-09T00:00:00,1625,1625,364,1989
ΚΙΛΚΙΣ,203,118,62,0,180,2021-02-09T00:00:00,2646,2646,439,3085
ΚΟΖΑΝΗΣ,303,199,113,6,312,2021-02-09T00:00:00,3789,3789,895,4684
ΚΟΡΙΝΘΙΑΣ,1003,126,30,-24,156,2021-02-09T00:00:00,2690,2690,376,3066
ΚΩ,1206,3,57,36,60,2021-02-09T00:00:00,925,925,184,1109
ΛΑΚΩΝΙΑΣ,1004,15,138,-4,153,2021-02-09T00:00:00,2797,2797,605,3402
ΛΑΡΙΣΑΣ,502,248,100,-54,348,2021-02-09T00:00:00,6954,6954,2080,9034
ΛΑΣΙΘΙΟΥ,1302,15,194,113,209,2021-02-09T00:00:00,3871,3871,788,4659
ΛΕΣΒΟΥ,1102,8,166,72,174,2021-02-09T00:00:00,2542,2542,445,2987
ΛΕΥΚΑΔΑΣ,605,255,35,236,290,2021-02-09T00:00:00,1235,1235,168,1403
ΛΗΜΝΟΥ,1103,7,53,36,60,2021-02-09T00:00:00,746,746,218,964
ΜΑΓΝΗΣΙΑΣ,503,108,42,-36,150,2021-02-09T00:00:00,4005,4005,717,4722
ΜΕΣΣΗΝΙΑΣ,1005,162,97,-19,259,2021-02-09T00:00:00,4701,4701,762,5463
ΜΗΛΟΥ,1207,0,0,-35,0,2021-02-09T00:00:00,188,188,2,190
ΜΥΚΟΝΟΥ,1208,0,0,0,0,2021-02-09T00:00:00,144,144,0,144
ΝΑΞΟΥ,1209,5,11,4,16,2021-02-09T00:00:00,432,432,70,502
ΝΗΣΩΝ,906,29,17,-8,46,2021-02-09T00:00:00,1567,1567,57,1624
ΝΟΤΙΟΥ ΤΟΜΕΑ ΑΘΗΝΩΝ,907,450,98,75,548,2021-02-09T00:00:00,6935,6935,1440,8375
ΞΑΝΘΗΣ,105,87,57,-12,144,2021-02-09T00:00:00,2244,2244,661,2905
ΠΑΡΟΥ,1210,0,0,-6,0,2021-02-09T00:00:00,280,280,2,282
ΠΕΙΡΑΙΩΣ,908,612,210,-20,822,2021-02-09T00:00:00,13853,13853,3132,16985
ΠΕΛΛΑΣ,204,171,76,-105,247,2021-02-09T00:00:00,4675,4675,682,5357
ΠΙΕΡΙΑΣ,205,146,52,-24,198,2021-02-09T00:00:00,3397,3397,515,3912
ΠΡΕΒΕΖΑΣ,404,7,44,-9,51,2021-02-09T00:00:00,1079,1079,410,1489
ΡΕΘΥΜΝΟΥ,1303,30,45,18,75,2021-02-09T00:00:00,2346,2346,531,2877
ΡΟΔΟΠΗΣ,106,68,46,-6,114,2021-02-09T00:00:00,1791,1791,384,2175
ΡΟΔΟΥ,1211,74,84,8,158,2021-02-09T00:00:00,2320,2320,506,2826
ΣΑΜΟΥ,1104,27,27,6,54,2021-02-09T00:00:00,876,876,234,1110
ΣΕΡΡΩΝ,206,138,72,-24,210,2021-02-09T00:00:00,2930,2930,756,3686
ΣΠΟΡΑΔΩΝ,504,0,0,0,0,2021-02-09T00:00:00,201,201,3,204
ΣΥΡΟΥ,1212,28,26,0,54,2021-02-09T00:00:00,863,863,188,1051
ΤΗΝΟΥ,1213,0,0,0,0,2021-02-09T00:00:00,280,280,1,281
ΤΡΙΚΑΛΩΝ,505,182,70,-54,252,2021-02-09T00:00:00,4080,4080,822,4902
ΦΘΙΩΤΙΔΑΣ,804,93,57,-18,150,2021-02-09T00:00:00,3143,3143,818,3961
ΦΛΩΡΙΝΑΣ,304,32,30,-3,62,2021-02-09T00:00:00,1601,1601,312,1913
ΦΩΚΙΔΑΣ,805,3,45,-18,48,2021-02-09T00:00:00,957,957,174,1131
ΧΑΛΚΙΔΙΚΗΣ,207,138,30,-30,168,2021-02-09T00:00:00,2171,2171,326,2497
ΧΑΝΙΩΝ,1304,269,102,48,371,2021-02-09T00:00:00,6518,6518,1140,7658
ΧΙΟΥ,1105,53,42,-1,95,2021-02-09T00:00:00,1137,1137,325,1462
ΑΙΤΩΛΟΑΚΑΡΝΑΝΙΑΣ,701,123,69,-4,192,2021-02-10T00:00:00,3476,3476,1004,4480
ΑΝΑΤΟΛΙΚΗΣ ΑΤΤΙΚΗΣ,901,218,263,-52,481,2021-02-10T00:00:00,8980,8980,990,9970
ΑΝΔΡΟΥ,1201,0,0,0,0,2021-02-10T00:00:00,263,263,1,264
ΑΡΓΟΛΙΔΑΣ,1001,11,169,16,180,2021-02-10T00:00:00,2805,2805,688,3493
ΑΡΚΑΔΙΑΣ,1002,22,104,24,126,2021-02-10T00:00:00,2743,2743,705,3448
ΑΡΤΑΣ,401,27,129,-3,156,2021-02-10T00:00:00,2947,2947,762,3709
ΑΧΑΪΑΣ,702,85,393,176,478,2021-02-10T00:00:00,9496,9496,2950,12446
ΒΟΙΩΤΙΑΣ,801,19,148,57,167,2021-02-10T00:00:00,2600,2600,613,3213
ΒΟΡΕΙΟΥ ΤΟΜΕΑ ΑΘΗΝΩΝ,902,529,1601,-335,2130,2021-02-10T00:00:00,41623,41623,16262,57885
ΓΡΕΒΕΝΩΝ,301,67,35,-12,102,2021-02-10T00:00:00,1083,1083,316,1399
ΔΡΑΜΑΣ,101,74,146,22,220,2021-02-10T00:00:00,2982,2982,663,3645
ΔΥΤΙΚΗΣ ΑΤΤΙΚΗΣ,903,11,115,102,126,2021-02-10T00:00:00,2966,2966,702,3668
ΔΥΤΙΚΟΥ ΤΟΜΕΑ ΑΘΗΝΩΝ,904,757,434,-100,1191,2021-02-10T00:00:00,15806,15806,3468,19274
ΕΒΡΟΥ,102,67,287,48,354,2021-02-10T00:00:00,5010,5010,1727,6737
ΕΥΒΟΙΑΣ,802,18,402,157,420,2021-02-10T00:00:00,5652,5652,1339,6991
ΕΥΡΥΤΑΝΙΑΣ,803,6,30,-8,36,2021-02-10T00:00:00,644,644,239,883
ΖΑΚΥΝΘΟΥ,601,7,95,42,102,2021-02-10T00:00:00,1296,1296,334,1630
ΗΛΕΙΑΣ,703,23,159,4,182,2021-02-10T00:00:00,3611,3611,910,4521
ΗΜΑΘΙΑΣ,201,123,135,-7,258,2021-02-10T00:00:00,3946,3946,901,4847
ΗΡΑΚΛΕΙΟΥ,1301,60,538,179,598,2021-02-10T00:00:00,9031,9031,3691,12722
ΘΑΣΟΥ,103,5,1,-6,6,2021-02-10T00:00:00,405,405,14,419
ΘΕΣΠΡΩΤΙΑΣ,402,59,90,-13,149,2021-02-10T00:00:00,2104,2104,473,2577
ΘΕΣΣΑΛΟΝΙΚΗΣ,202,947,1394,214,2341,2021-02-10T00:00:00,38609,38609,13371,51980
ΘΗΡΑΣ,1202,9,15,-6,24,2021-02-10T00:00:00,327,327,80,407
ΙΘΑΚΗΣ,602,0,0,0,0,2021-02-10T00:00:00,0,0,0,0
ΙΚΑΡΙΑΣ,1101,2,16,-5,18,2021-02-10T00:00:00,684,684,78,762
ΙΩΑΝΝΙΝΩΝ,403,133,241,36,374,2021-02-10T00:00:00,7336,7336,3185,10521
ΚΑΒΑΛΑΣ,104,105,147,0,252,2021-02-10T00:00:00,3972,3972,891,4863
ΚΑΛΥΜΝΟΥ,1203,2,34,30,36,2021-02-10T00:00:00,683,683,180,863
ΚΑΡΔΙΤΣΑΣ,501,24,221,125,245,2021-02-10T00:00:00,3861,3861,920,4781
ΚΑΡΠΑΘΟΥ,1204,0,12,12,12,2021-02-10T00:00:00,252,252,27,279
ΚΑΣΤΟΡΙΑΣ,302,61,59,-29,120,2021-02-10T00:00:00,1915,1915,428,2343
ΚΕΑΣ-ΚΥΘΝΟΥ,1205,0,0,0,0,2021-02-10T00:00:00,0,0,0,0
ΚΕΝΤΡΙΚΟΥ ΤΟΜΕΑ ΑΘΗΝΩΝ,905,1815,1590,73,3405,2021-02-10T00:00:00,56048,56048,21792,77840
ΚΕΡΚΥΡΑΣ,603,19,222,38,241,2021-02-10T00:00:00,3028,3028,640,3668
ΚΕΦΑΛΛΗΝΙΑΣ,604,4,132,10,136,2021-02-10T00:00:00,1629,1629,496,2125
ΚΙΛΚΙΣ,203,131,182,133,313,2021-02-10T00:00:00,2777,2777,621,3398
ΚΟΖΑΝΗΣ,303,193,107,-12,300,2021-02-10T00:00:00,3982,3982,1002,4984
ΚΟΡΙΝΘΙΑΣ,1003,80,70,-6,150,2021-02-10T00:00:00,2770,2770,446,3216
ΚΩ,1206,2,64,6,66,2021-02-10T00:00:00,927,927,248,1175
ΛΑΚΩΝΙΑΣ,1004,12,150,9,162,2021-02-10T00:00:00,2809,2809,755,3564
ΛΑΡΙΣΑΣ,502,175,197,24,372,2021-02-10T00:00:00,7129,7129,2277,9406
ΛΑΣΙΘΙΟΥ,1302,19,238,48,257,2021-02-10T00:00:00,3890,3890,1026,4916
ΛΕΣΒΟΥ,1102,15,147,-12,162,2021-02-10T00:00:00,2557,2557,592,3149
ΛΕΥΚΑΔΑΣ,605,94,45,-151,139,2021-02-10T00:00:00,1329,1329,213,1542
ΛΗΜΝΟΥ,1103,7,41,-12,48,2021-02-10T00:00:00,753,753,259,1012
ΜΑΓΝΗΣΙΑΣ,503,113,72,35,185,2021-02-10T00:00:00,4118,4118,789,4907
ΜΕΣΣΗΝΙΑΣ,1005,84,173,-2,257,2021-02-10T00:00:00,4785,4785,935,5720
ΜΗΛΟΥ,1207,24,0,24,24,2021-02-10T00:00:00,212,212,2,214
ΜΥΚΟΝΟΥ,1208,0,0,0,0,2021-02-10T00:00:00,144,144,0,144
ΝΑΞΟΥ,1209,2,28,14,30,2021-02-10T00:00:00,434,434,98,532
ΝΗΣΩΝ,906,29,19,2,48,2021-02-10T00:00:00,1596,1596,76,1672
ΝΟΤΙΟΥ ΤΟΜΕΑ ΑΘΗΝΩΝ,907,283,268,3,551,2021-02-10T00:00:00,7218,7218,1708,8926
ΞΑΝΘΗΣ,105,38,113,7,151,2021-02-10T00:00:00,2282,2282,774,3056
ΠΑΡΟΥ,1210,6,0,6,6,2021-02-10T00:00:00,286,286,2,288
ΠΕΙΡΑΙΩΣ,908,273,445,-104,718,2021-02-10T00:00:00,14126,14126,3577,17703
ΠΕΛΛΑΣ,204,123,194,70,317,2021-02-10T00:00:00,4798,4798,876,5674
ΠΙΕΡΙΑΣ,205,117,105,24,222,2021-02-10T00:00:00,3514,3514,620,4134
ΠΡΕΒΕΖΑΣ,404,12,45,6,57,2021-02-10T00:00:00,1091,1091,455,1546
ΡΕΘΥΜΝΟΥ,1303,24,150,99,174,2021-02-10T00:00:00,2370,2370,681,3051
ΡΟΔΟΠΗΣ,106,67,89,42,156,2021-02-10T00:00:00,1858,1858,473,2331
ΡΟΔΟΥ,1211,39,93,-26,132,2021-02-10T00:00:00,2359,2359,599,2958
ΣΑΜΟΥ,1104,5,43,-6,48,2021-02-10T00:00:00,881,881,277,1158
ΣΕΡΡΩΝ,206,100,122,12,222,2021-02-10T00:00:00,3030,3030,878,3908
ΣΠΟΡΑΔΩΝ,504,18,0,18,18,2021-02-10T00:00:00,219,219,3,222
ΣΥΡΟΥ,1212,8,46,0,54,2021-02-10T00:00:00,871,871,234,1105
ΤΗΝΟΥ,1213,0,0,0,0,2021-02-10T00:00:00,280,280,1,281
ΤΡΙΚΑΛΩΝ,505,87,178,13,265,2021-02-10T00:00:00,4167,4167,1000,5167
ΦΘΙΩΤΙΔΑΣ,804,102,132,84,234,2021-02-10T00:00:00,3245,3245,950,4195
ΦΛΩΡΙΝΑΣ,304,26,64,28,90,2021-02-10T00:00:00,1627,1627,376,2003
ΦΩΚΙΔΑΣ,805,7,45,4,52,2021-02-10T00:00:00,964,964,219,1183
ΧΑΛΚΙΔΙΚΗΣ,207,99,87,18,186,2021-02-10T00:00:00,2270,2270,413,2683
ΧΑΝΙΩΝ,1304,76,333,38,409,2021-02-10T00:00:00,6594,6594,1473,8067
ΧΙΟΥ,1105,200,30,135,230,2021-02-10T00:00:00,1337,1337,355,1692
ΑΙΤΩΛΟΑΚΑΡΝΑΝΙΑΣ,701,0,0,0,0,2020-12-31T00:00:00,0,0,0,0
ΑΝΑΤΟΛΙΚΗΣ ΑΤΤΙΚΗΣ,901,45,0,5,45,2020-12-31T00:00:00,231,231,0,231
ΑΝΔΡΟΥ,1201,0,0,0,0,2020-12-31T00:00:00,0,0,0,0
ΑΡΓΟΛΙΔΑΣ,1001,0,0,0,0,2020-12-31T00:00:00,0,0,0,0
ΑΡΚΑΔΙΑΣ,1002,0,0,0,0,2020-12-31T00:00:00,0,0,0,0
ΑΡΤΑΣ,401,0,0,0,0,2020-12-31T00:00:00,0,0,0,0
ΑΧΑΪΑΣ,702,100,0,3,100,2020-12-31T00:00:00,311,311,0,311
ΒΟΙΩΤΙΑΣ,801,0,0,0,0,2020-12-31T00:00:00,0,0,0,0
ΒΟΡΕΙΟΥ ΤΟΜΕΑ ΑΘΗΝΩΝ,902,0,0,0,0,2020-12-31T00:00:00,0,0,0,0
ΓΡΕΒΕΝΩΝ,301,0,0,0,0,2020-12-31T00:00:00,0,0,0,0
ΔΡΑΜΑΣ,101,0,0,0,0,2020-12-31T00:00:00,0,0,0,0
ΔΥΤΙΚΗΣ ΑΤΤΙΚΗΣ,903,35,0,-14,35,2020-12-31T00:00:00,234,234,0,234
ΔΥΤΙΚΟΥ ΤΟΜΕΑ ΑΘΗΝΩΝ,904,20,0,-20,20,2020-12-31T00:00:00,220,220,0,220
ΕΒΡΟΥ,102,0,0,0,0,2020-12-31T00:00:00,0,0,0,0
ΕΥΒΟΙΑΣ,802,0,0,0,0,2020-12-31T00:00:00,0,0,0,0
ΕΥΡΥΤΑΝΙΑΣ,803,0,0,0,0,2020-12-31T00:00:00,0,0,0,0
ΖΑΚΥΝΘΟΥ,601,0,0,0,0,2020-12-31T00:00:00,0,0,0,0
ΗΛΕΙΑΣ,703,0,0,0,0,2020-12-31T00:00:00,0,0,0,0
ΗΜΑΘΙΑΣ,201,0,0,0,0,2020-12-31T00:00:00,0,0,0,0
ΗΡΑΚΛΕΙΟΥ,1301,0,0,0,0,2020-12-31T00:00:00,0,0,0,0
ΘΑΣΟΥ,103,0,0,0,0,2020-12-31T00:00:00,0,0,0,0
ΘΕΣΠΡΩΤΙΑΣ,402,0,0,0,0,2020-12-31T00:00:00,0,0,0,0
ΘΕΣΣΑΛΟΝΙΚΗΣ,202,80,0,1,80,2020-12-31T00:00:00,217,217,0,217
ΘΗΡΑΣ,1202,0,0,0,0,2020-12-31T00:00:00,0,0,0,0
ΙΘΑΚΗΣ,602,0,0,0,0,2020-12-31T00:00:00,0,0,0,0
ΙΚΑΡΙΑΣ,1101,0,0,0,0,2020-12-31T00:00:00,0,0,0,0
ΙΩΑΝΝΙΝΩΝ,403,101,0,1,101,2020-12-31T00:00:00,278,278,0,278
ΚΑΒΑΛΑΣ,104,0,0,0,0,2020-12-31T00:00:00,0,0,0,0
ΚΑΛΥΜΝΟΥ,1203,0,0,0,0,2020-12-31T00:00:00,0,0,0,0
ΚΑΡΔΙΤΣΑΣ,501,0,0,0,0,2020-12-31T00:00:00,0,0,0,0
ΚΑΡΠΑΘΟΥ,1204,0,0,0,0,2020-12-31T00:00:00,0,0,0,0
ΚΑΣΤΟΡΙΑΣ,302,0,0,0,0,2020-12-31T00:00:00,0,0,0,0
ΚΕΑΣ-ΚΥΘΝΟΥ,1205,0,0,0,0,2020-12-31T00:00:00,0,0,0,0
ΚΕΝΤΡΙΚΟΥ ΤΟΜΕΑ ΑΘΗΝΩΝ,905,120,0,25,120,2020-12-31T00:00:00,482,482,0,482
ΚΕΡΚΥΡΑΣ,603,0,0,0,0,2020-12-31T00:00:00,0,0,0,0
ΚΕΦΑΛΛΗΝΙΑΣ,604,0,0,0,0,2020-12-31T00:00:00,0,0,0,0
ΚΙΛΚΙΣ,203,0,0,0,0,2020-12-31T00:00:00,0,0,0,0
ΚΟΖΑΝΗΣ,303,0,0,0,0,2020-12-31T00:00:00,0,0,0,0
ΚΟΡΙΝΘΙΑΣ,1003,0,0,0,0,2020-12-31T00:00:00,0,0,0,0
ΚΩ,1206,0,0,0,0,2020-12-31T00:00:00,0,0,0,0
ΛΑΚΩΝΙΑΣ,1004,0,0,0,0,2020-12-31T00:00:00,0,0,0,0
ΛΑΡΙΣΑΣ,502,116,0,-29,116,2020-12-31T00:00:00,366,366,0,366
ΛΑΣΙΘΙΟΥ,1302,0,0,0,0,2020-12-31T00:00:00,0,0,0,0
ΛΕΣΒΟΥ,1102,0,0,0,0,2020-12-31T00:00:00,0,0,0,0
ΛΕΥΚΑΔΑΣ,605,0,0,0,0,2020-12-31T00:00:00,0,0,0,0
ΛΗΜΝΟΥ,1103,0,0,0,0,2020-12-31T00:00:00,0,0,0,0
ΜΑΓΝΗΣΙΑΣ,503,0,0,0,0,2020-12-31T00:00:00,0,0,0,0
ΜΕΣΣΗΝΙΑΣ,1005,0,0,0,0,2020-12-31T00:00:00,0,0,0,0
ΜΗΛΟΥ,1207,0,0,0,0,2020-12-31T00:00:00,0,0,0,0
ΜΥΚΟΝΟΥ,1208,0,0,0,0,2020-12-31T00:00:00,0,0,0,0
ΝΑΞΟΥ,1209,0,0,0,0,2020-12-31T00:00:00,0,0,0,0
ΝΗΣΩΝ,906,0,0,0,0,2020-12-31T00:00:00,0,0,0,0
ΝΟΤΙΟΥ ΤΟΜΕΑ ΑΘΗΝΩΝ,907,0,0,0,0,2020-12-31T00:00:00,0,0,0,0
ΞΑΝΘΗΣ,105,0,0,0,0,2020-12-31T00:00:00,0,0,0,0
ΠΑΡΟΥ,1210,0,0,0,0,2020-12-31T00:00:00,0,0,0,0
ΠΕΙΡΑΙΩΣ,908,0,0,0,0,2020-12-31T00:00:00,0,0,0,0
ΠΕΛΛΑΣ,204,0,0,0,0,2020-12-31T00:00:00,0,0,0,0
ΠΙΕΡΙΑΣ,205,0,0,0,0,2020-12-31T00:00:00,0,0,0,0
ΠΡΕΒΕΖΑΣ,404,0,0,0,0,2020-12-31T00:00:00,0,0,0,0
ΡΕΘΥΜΝΟΥ,1303,0,0,0,0,2020-12-31T00:00:00,0,0,0,0
ΡΟΔΟΠΗΣ,106,0,0,0,0,2020-12-31T00:00:00,0,0,0,0
ΡΟΔΟΥ,1211,0,0,0,0,2020-12-31T00:00:00,0,0,0,0
ΣΑΜΟΥ,1104,0,0,0,0,2020-12-31T00:00:00,0,0,0,0
ΣΕΡΡΩΝ,206,0,0,0,0,2020-12-31T00:00:00,0,0,0,0
ΣΠΟΡΑΔΩΝ,504,0,0,0,0,2020-12-31T00:00:00,0,0,0,0
ΣΥΡΟΥ,1212,0,0,0,0,2020-12-31T00:00:00,0,0,0,0
ΤΗΝΟΥ,1213,0,0,0,0,2020-12-31T00:00:00,0,0,0,0
ΤΡΙΚΑΛΩΝ,505,0,0,0,0,2020-12-31T00:00:00,0,0,0,0
ΦΘΙΩΤΙΔΑΣ,804,0,0,0,0,2020-12-31T00:00:00,0,0,0,0
ΦΛΩΡΙΝΑΣ,304,0,0,0,0,2020-12-31T00:00:00,0,0,0,0
ΦΩΚΙΔΑΣ,805,0,0,0,0,2020-12-31T00:00:00,0,0,0,0
ΧΑΛΚΙΔΙΚΗΣ,207,0,0,0,0,2020-12-31T00:00:00,0,0,0,0
ΧΑΝΙΩΝ,1304,0,0,0,0,2020-12-31T00:00:00,0,0,0,0
ΧΙΟΥ,1105,0,0,0,0,2020-12-31T00:00:00,0,0,0,0
ΑΙΤΩΛΟΑΚΑΡΝΑΝΙΑΣ,701,0,0,0,0,2021-01-01T00:00:00,0,0,0,0
ΑΝΑΤΟΛΙΚΗΣ ΑΤΤΙΚΗΣ,901,45,0,0,45,2021-01-01T00:00:00,276,276,0,276
ΑΝΔΡΟΥ,1201,0,0,0,0,2021-01-01T00:00:00,0,0,0,0
ΑΡΓΟΛΙΔΑΣ,1001,0,0,0,0,2021-01-01T00:00:00,0,0,0,0
ΑΡΚΑΔΙΑΣ,1002,0,0,0,0,2021-01-01T00:00:00,0,0,0,0
ΑΡΤΑΣ,401,0,0,0,0,2021-01-01T00:00:00,0,0,0,0
ΑΧΑΪΑΣ,702,0,0,-100,0,2021-01-01T00:00:00,311,311,0,311
ΒΟΙΩΤΙΑΣ,801,0,0,0,0,2021-01-01T00:00:00,0,0,0,0
ΒΟΡΕΙΟΥ ΤΟΜΕΑ ΑΘΗΝΩΝ,902,0,0,0,0,2021-01-01T00:00:00,0,0,0,0
ΓΡΕΒΕΝΩΝ,301,0,0,0,0,2021-01-01T00:00:00,0,0,0,0
ΔΡΑΜΑΣ,101,0,0,0,0,2021-01-01T00:00:00,0,0,0,0
ΔΥΤΙΚΗΣ ΑΤΤΙΚΗΣ,903,0,0,-35,0,2021-01-01T00:00:00,234,234,0,234
ΔΥΤΙΚΟΥ ΤΟΜΕΑ ΑΘΗΝΩΝ,904,30,0,10,30,2021-01-01T00:00:00,250,250,0,250
ΕΒΡΟΥ,102,0,0,0,0,2021-01-01T00:00:00,0,0,0,0
ΕΥΒΟΙΑΣ,802,0,0,0,0,2021-01-01T00:00:00,0,0,0,0
ΕΥΡΥΤΑΝΙΑΣ,803,0,0,0,0,2021-01-01T00:00:00,0,0,0,0
ΖΑΚΥΝΘΟΥ,601,0,0,0,0,2021-01-01T00:00:00,0,0,0,0
ΗΛΕΙΑΣ,703,0,0,0,0,2021-01-01T00:00:00,0,0,0,0
ΗΜΑΘΙΑΣ,201,0,0,0,0,2021-01-01T00:00:00,0,0,0,0
ΗΡΑΚΛΕΙΟΥ,1301,0,0,0,0,2021-01-01T00:00:00,0,0,0,0
ΘΑΣΟΥ,103,0,0,0,0,2021-01-01T00:00:00,0,0,0,0
ΘΕΣΠΡΩΤΙΑΣ,402,0,0,0,0,2021-01-01T00:00:00,0,0,0,0
ΘΕΣΣΑΛΟΝΙΚΗΣ,202,40,0,-40,40,2021-01-01T00:00:00,257,257,0,257
ΘΗΡΑΣ,1202,0,0,0,0,2021-01-01T00:00:00,0,0,0,0
ΙΘΑΚΗΣ,602,0,0,0,0,2021-01-01T00:00:00,0,0,0,0
ΙΚΑΡΙΑΣ,1101,0,0,0,0,2021-01-01T00:00:00,0,0,0,0
ΙΩΑΝΝΙΝΩΝ,403,0,0,-101,0,2021-01-01T00:00:00,278,278,0,278
ΚΑΒΑΛΑΣ,104,0,0,0,0,2021-01-01T00:00:00,0,0,0,0
ΚΑΛΥΜΝΟΥ,1203,0,0,0,0,2021-01-01T00:00:00,0,0,0,0
ΚΑΡΔΙΤΣΑΣ,501,0,0,0,0,2021-01-01T00:00:00,0,0,0,0
ΚΑΡΠΑΘΟΥ,1204,0,0,0,0,2021-01-01T00:00:00,0,0,0,0
ΚΑΣΤΟΡΙΑΣ,302,0,0,0,0,2021-01-01T00:00:00,0,0,0,0
ΚΕΑΣ-ΚΥΘΝΟΥ,1205,0,0,0,0,2021-01-01T00:00:00,0,0,0,0
ΚΕΝΤΡΙΚΟΥ ΤΟΜΕΑ ΑΘΗΝΩΝ,905,89,0,-31,89,2021-01-01T00:00:00,571,571,0,571
ΚΕΡΚΥΡΑΣ,603,0,0,0,0,2021-01-01T00:00:00,0,0,0,0
ΚΕΦΑΛΛΗΝΙΑΣ,604,0,0,0,0,2021-01-01T00:00:00,0,0,0,0
ΚΙΛΚΙΣ,203,0,0,0,0,2021-01-01T00:00:00,0,0,0,0
ΚΟΖΑΝΗΣ,303,0,0,0,0,2021-01-01T00:00:00,0,0,0,0
ΚΟΡΙΝΘΙΑΣ,1003,0,0,0,0,2021-01-01T00:00:00,0,0,0,0
ΚΩ,1206,0,0,0,0,2021-01-01T00:00:00,0,0,0,0
ΛΑΚΩΝΙΑΣ,1004,0,0,0,0,2021-01-01T00:00:00,0,0,0,0
ΛΑΡΙΣΑΣ,502,60,0,-56,60,2021-01-01T00:00:00,426,426,0,426
ΛΑΣΙΘΙΟΥ,1302,0,0,0,0,2021-01-01T00:00:00,0,0,0,0
ΛΕΣΒΟΥ,1102,0,0,0,0,2021-01-01T00:00:00,0,0,0,0
ΛΕΥΚΑΔΑΣ,605,0,0,0,0,2021-01-01T00:00:00,0,0,0,0
ΛΗΜΝΟΥ,1103,0,0,0,0,2021-01-01T00:00:00,0,0,0,0
ΜΑΓΝΗΣΙΑΣ,503,0,0,0,0,2021-01-01T00:00:00,0,0,0,0
ΜΕΣΣΗΝΙΑΣ,1005,0,0,0,0,2021-01-01T00:00:00,0,0,0,0
ΜΗΛΟΥ,1207,0,0,0,0,2021-01-01T00:00:00,0,0,0,0
ΜΥΚΟΝΟΥ,1208,0,0,0,0,2021-01-01T00:00:00,0,0,0,0
ΝΑΞΟΥ,1209,0,0,0,0,2021-01-01T00:00:00,0,0,0,0
ΝΗΣΩΝ,906,0,0,0,0,2021-01-01T00:00:00,0,0,0,0
ΝΟΤΙΟΥ ΤΟΜΕΑ ΑΘΗΝΩΝ,907,0,0,0,0,2021-01-01T00:00:00,0,0,0,0
ΞΑΝΘΗΣ,105,0,0,0,0,2021-01-01T00:00:00,0,0,0,0
ΠΑΡΟΥ,1210,0,0,0,0,2021-01-01T00:00:00,0,0,0,0
ΠΕΙΡΑΙΩΣ,908,0,0,0,0,2021-01-01T00:00:00,0,0,0,0
ΠΕΛΛΑΣ,204,0,0,0,0,2021-01-01T00:00:00,0,0,0,0
ΠΙΕΡΙΑΣ,205,0,0,0,0,2021-01-01T00:00:00,0,0,0,0
ΠΡΕΒΕΖΑΣ,404,0,0,0,0,2021-01-01T00:00:00,0,0,0,0
ΡΕΘΥΜΝΟΥ,1303,0,0,0,0,2021-01-01T00:00:00,0,0,0,0
ΡΟΔΟΠΗΣ,106,0,0,0,0,2021-01-01T00:00:00,0,0,0,0
ΡΟΔΟΥ,1211,0,0,0,0,2021-01-01T00:00:00,0,0,0,0
ΣΑΜΟΥ,1104,0,0,0,0,2021-01-01T00:00:00,0,0,0,0
ΣΕΡΡΩΝ,206,0,0,0,0,2021-01-01T00:00:00,0,0,0,0
ΣΠΟΡΑΔΩΝ,504,0,0,0,0,2021-01-01T00:00:00,0,0,0,0
ΣΥΡΟΥ,1212,0,0,0,0,2021-01-01T00:00:00,0,0,0,0
ΤΗΝΟΥ,1213,0,0,0,0,2021-01-01T00:00:00,0,0,0,0
ΤΡΙΚΑΛΩΝ,505,0,0,0,0,2021-01-01T00:00:00,0,0,0,0
ΦΘΙΩΤΙΔΑΣ,804,0,0,0,0,2021-01-01T00:00:00,0,0,0,0
ΦΛΩΡΙΝΑΣ,304,0,0,0,0,2021-01-01T00:00:00,0,0,0,0
ΦΩΚΙΔΑΣ,805,0,0,0,0,2021-01-01T00:00:00,0,0,0,0
ΧΑΛΚΙΔΙΚΗΣ,207,0,0,0,0,2021-01-01T00:00:00,0,0,0,0
ΧΑΝΙΩΝ,1304,0,0,0,0,2021-01-01T00:00:00,0,0,0,0
ΧΙΟΥ,1105,0,0,0,0,2021-01-01T00:00:00,0,0,0,0
ΑΙΤΩΛΟΑΚΑΡΝΑΝΙΑΣ,701,0,0,0,0,2021-01-02T00:00:00,0,0,0,0
ΑΝΑΤΟΛΙΚΗΣ ΑΤΤΙΚΗΣ,901,50,0,5,50,2021-01-02T00:00:00,326,326,0,326
ΑΝΔΡΟΥ,1201,0,0,0,0,2021-01-02T00:00:00,0,0,0,0
ΑΡΓΟΛΙΔΑΣ,1001,0,0,0,0,2021-01-02T00:00:00,0,0,0,0
ΑΡΚΑΔΙΑΣ,1002,0,0,0,0,2021-01-02T00:00:00,0,0,0,0
ΑΡΤΑΣ,401,0,0,0,0,2021-01-02T00:00:00,0,0,0,0
ΑΧΑΪΑΣ,702,105,0,105,105,2021-01-02T00:00:00,416,416,0,416
ΒΟΙΩΤΙΑΣ,801,0,0,0,0,2021-01-02T00:00:00,0,0,0,0
ΒΟΡΕΙΟΥ ΤΟΜΕΑ ΑΘΗΝΩΝ,902,0,0,0,0,2021-01-02T00:00:00,0,0,0,0
ΓΡΕΒΕΝΩΝ,301,0,0,0,0,2021-01-02T00:00:00,0,0,0,0
ΔΡΑΜΑΣ,101,0,0,0,0,2021-01-02T00:00:00,0,0,0,0
ΔΥΤΙΚΗΣ ΑΤΤΙΚΗΣ,903,0,0,0,0,2021-01-02T00:00:00,234,234,0,234
ΔΥΤΙΚΟΥ ΤΟΜΕΑ ΑΘΗΝΩΝ,904,65,0,35,65,2021-01-02T00:00:00,315,315,0,315
ΕΒΡΟΥ,102,0,0,0,0,2021-01-02T00:00:00,0,0,0,0
ΕΥΒΟΙΑΣ,802,0,0,0,0,2021-01-02T00:00:00,0,0,0,0
ΕΥΡΥΤΑΝΙΑΣ,803,0,0,0,0,2021-01-02T00:00:00,0,0,0,0
ΖΑΚΥΝΘΟΥ,601,0,0,0,0,2021-01-02T00:00:00,0,0,0,0
ΗΛΕΙΑΣ,703,0,0,0,0,2021-01-02T00:00:00,0,0,0,0
ΗΜΑΘΙΑΣ,201,0,0,0,0,2021-01-02T00:00:00,0,0,0,0
ΗΡΑΚΛΕΙΟΥ,1301,0,0,0,0,2021-01-02T00:00:00,0,0,0,0
ΘΑΣΟΥ,103,0,0,0,0,2021-01-02T00:00:00,0,0,0,0
ΘΕΣΠΡΩΤΙΑΣ,402,0,0,0,0,2021-01-02T00:00:00,0,0,0,0
ΘΕΣΣΑΛΟΝΙΚΗΣ,202,81,0,41,81,2021-01-02T00:00:00,338,338,0,338
ΘΗΡΑΣ,1202,0,0,0,0,2021-01-02T00:00:00,0,0,0,0
ΙΘΑΚΗΣ,602,0,0,0,0,2021-01-02T00:00:00,0,0,0,0
ΙΚΑΡΙΑΣ,1101,0,0,0,0,2021-01-02T00:00:00,0,0,0,0
ΙΩΑΝΝΙΝΩΝ,403,70,0,70,70,2021-01-02T00:00:00,348,348,0,348
ΚΑΒΑΛΑΣ,104,0,0,0,0,2021-01-02T00:00:00,0,0,0,0
ΚΑΛΥΜΝΟΥ,1203,0,0,0,0,2021-01-02T00:00:00,0,0,0,0
ΚΑΡΔΙΤΣΑΣ,501,0,0,0,0,2021-01-02T00:00:00,0,0,0,0
ΚΑΡΠΑΘΟΥ,1204,0,0,0,0,2021-01-02T00:00:00,0,0,0,0
ΚΑΣΤΟΡΙΑΣ,302,0,0,0,0,2021-01-02T00:00:00,0,0,0,0
ΚΕΑΣ-ΚΥΘΝΟΥ,1205,0,0,0,0,2021-01-02T00:00:00,0,0,0,0
ΚΕΝΤΡΙΚΟΥ ΤΟΜΕΑ ΑΘΗΝΩΝ,905,130,0,41,130,2021-01-02T00:00:00,701,701,0,701
ΚΕΡΚΥΡΑΣ,603,0,0,0,0,2021-01-02T00:00:00,0,0,0,0
ΚΕΦΑΛΛΗΝΙΑΣ,604,0,0,0,0,2021-01-02T00:00:00,0,0,0,0
ΚΙΛΚΙΣ,203,0,0,0,0,2021-01-02T00:00:00,0,0,0,0
ΚΟΖΑΝΗΣ,303,0,0,0,0,2021-01-02T00:00:00,0,0,0,0
ΚΟΡΙΝΘΙΑΣ,1003,0,0,0,0,2021-01-02T00:00:00,0,0,0,0
ΚΩ,1206,0,0,0,0,2021-01-02T00:00:00,0,0,0,0
ΛΑΚΩΝΙΑΣ,1004,0,0,0,0,2021-01-02T00:00:00,0,0,0,0
ΛΑΡΙΣΑΣ,502,45,0,-15,45,2021-01-02T00:00:00,471,471,0,471
ΛΑΣΙΘΙΟΥ,1302,0,0,0,0,2021-01-02T00:00:00,0,0,0,0
ΛΕΣΒΟΥ,1102,0,0,0,0,2021-01-02T00:00:00,0,0,0,0
ΛΕΥΚΑΔΑΣ,605,0,0,0,0,2021-01-02T00:00:00,0,0,0,0
ΛΗΜΝΟΥ,1103,0,0,0,0,2021-01-02T00:00:00,0,0,0,0
ΜΑΓΝΗΣΙΑΣ,503,0,0,0,0,2021-01-02T00:00:00,0,0,0,0
ΜΕΣΣΗΝΙΑΣ,1005,0,0,0,0,2021-01-02T00:00:00,0,0,0,0
ΜΗΛΟΥ,1207,0,0,0,0,2021-01-02T00:00:00,0,0,0,0
ΜΥΚΟΝΟΥ,1208,0,0,0,0,2021-01-02T00:00:00,0,0,0,0
ΝΑΞΟΥ,1209,0,0,0,0,2021-01-02T00:00:00,0,0,0,0
ΝΗΣΩΝ,906,0,0,0,0,2021-01-02T00:00:00,0,0,0,0
ΝΟΤΙΟΥ ΤΟΜΕΑ ΑΘΗΝΩΝ,907,0,0,0,0,2021-01-02T00:00:00,0,0,0,0
ΞΑΝΘΗΣ,105,0,0,0,0,2021-01-02T00:00:00,0,0,0,0
ΠΑΡΟΥ,1210,0,0,0,0,2021-01-02T00:00:00,0,0,0,0
ΠΕΙΡΑΙΩΣ,908,0,0,0,0,2021-01-02T00:00:00,0,0,0,0
ΠΕΛΛΑΣ,204,0,0,0,0,2021-01-02T00:00:00,0,0,0,0
ΠΙΕΡΙΑΣ,205,0,0,0,0,2021-01-02T00:00:00,0,0,0,0
ΠΡΕΒΕΖΑΣ,404,0,0,0,0,2021-01-02T00:00:00,0,0,0,0
ΡΕΘΥΜΝΟΥ,1303,0,0,0,0,2021-01-02T00:00:00,0,0,0,0
ΡΟΔΟΠΗΣ,106,0,0,0,0,2021-01-02T00:00:00,0,0,0,0
ΡΟΔΟΥ,1211,0,0,0,0,2021-01-02T00:00:00,0,0,0,0
ΣΑΜΟΥ,1104,0,0,0,0,2021-01-02T00:00:00,0,0,0,0
ΣΕΡΡΩΝ,206,0,0,0,0,2021-01-02T00:00:00,0,0,0,0
ΣΠΟΡΑΔΩΝ,504,0,0,0,0,2021-01-02T00:00:00,0,0,0,0
ΣΥΡΟΥ,1212,0,0,0,0,2021-01-02T00:00:00,0,0,0,0
ΤΗΝΟΥ,1213,0,0,0,0,2021-01-02T00:00:00,0,0,0,0
ΤΡΙΚΑΛΩΝ,505,0,0,0,0,2021-01-02T00:00:00,0,0,0,0
ΦΘΙΩΤΙΔΑΣ,804,0,0,0,0,2021-01-02T00:00:00,0,0,0,0
ΦΛΩΡΙΝΑΣ,304,0,0,0,0,2021-01-02T00:00:00,0,0,0,0
ΦΩΚΙΔΑΣ,805,0,0,0,0,2021-01-02T00:00:00,0,0,0,0
ΧΑΛΚΙΔΙΚΗΣ,207,0,0,0,0,2021-01-02T00:00:00,0,0,0,0
ΧΑΝΙΩΝ,1304,0,0,0,0,2021-01-02T00:00:00,0,0,0,0
ΧΙΟΥ,1105,0,0,0,0,2021-01-02T00:00:00,0,0,0,0
ΑΙΤΩΛΟΑΚΑΡΝΑΝΙΑΣ,701,0,0,0,0,2021-01-03T00:00:00,0,0,0,0
ΑΝΑΤΟΛΙΚΗΣ ΑΤΤΙΚΗΣ,901,55,0,5,55,2021-01-03T00:00:00,381,381,0,381
ΑΝΔΡΟΥ,1201,0,0,0,0,2021-01-03T00:00:00,0,0,0,0
ΑΡΓΟΛΙΔΑΣ,1001,0,0,0,0,2021-01-03T00:00:00,0,0,0,0
ΑΡΚΑΔΙΑΣ,1002,0,0,0,0,2021-01-03T00:00:00,0,0,0,0
ΑΡΤΑΣ,401,20,0,20,20,2021-01-03T00:00:00,20,20,0,20
ΑΧΑΪΑΣ,702,150,0,45,150,2021-01-03T00:00:00,566,566,0,566
ΒΟΙΩΤΙΑΣ,801,0,0,0,0,2021-01-03T00:00:00,0,0,0,0
ΒΟΡΕΙΟΥ ΤΟΜΕΑ ΑΘΗΝΩΝ,902,18,0,18,18,2021-01-03T00:00:00,18,18,0,18
ΓΡΕΒΕΝΩΝ,301,0,0,0,0,2021-01-03T00:00:00,0,0,0,0
ΔΡΑΜΑΣ,101,0,0,0,0,2021-01-03T00:00:00,0,0,0,0
ΔΥΤΙΚΗΣ ΑΤΤΙΚΗΣ,903,0,0,0,0,2021-01-03T00:00:00,234,234,0,234
ΔΥΤΙΚΟΥ ΤΟΜΕΑ ΑΘΗΝΩΝ,904,70,0,5,70,2021-01-03T00:00:00,385,385,0,385
ΕΒΡΟΥ,102,0,0,0,0,2021-01-03T00:00:00,0,0,0,0
ΕΥΒΟΙΑΣ,802,0,0,0,0,2021-01-03T00:00:00,0,0,0,0
ΕΥΡΥΤΑΝΙΑΣ,803,0,0,0,0,2021-01-03T00:00:00,0,0,0,0
ΖΑΚΥΝΘΟΥ,601,0,0,0,0,2021-01-03T00:00:00,0,0,0,0
ΗΛΕΙΑΣ,703,0,0,0,0,2021-01-03T00:00:00,0,0,0,0
ΗΜΑΘΙΑΣ,201,0,0,0,0,2021-01-03T00:00:00,0,0,0,0
ΗΡΑΚΛΕΙΟΥ,1301,0,0,0,0,2021-01-03T00:00:00,0,0,0,0
ΘΑΣΟΥ,103,0,0,0,0,2021-01-03T00:00:00,0,0,0,0
ΘΕΣΠΡΩΤΙΑΣ,402,0,0,0,0,2021-01-03T00:00:00,0,0,0,0
ΘΕΣΣΑΛΟΝΙΚΗΣ,202,123,0,42,123,2021-01-03T00:00:00,461,461,0,461
ΘΗΡΑΣ,1202,0,0,0,0,2021-01-03T00:00:00,0,0,0,0
ΙΘΑΚΗΣ,602,0,0,0,0,2021-01-03T00:00:00,0,0,0,0
ΙΚΑΡΙΑΣ,1101,0,0,0,0,2021-01-03T00:00:00,0,0,0,0
ΙΩΑΝΝΙΝΩΝ,403,80,0,10,80,2021-01-03T00:00:00,428,428,0,428
ΚΑΒΑΛΑΣ,104,0,0,0,0,2021-01-03T00:00:00,0,0,0,0
ΚΑΛΥΜΝΟΥ,1203,0,0,0,0,2021-01-03T00:00:00,0,0,0,0
ΚΑΡΔΙΤΣΑΣ,501,0,0,0,0,2021-01-03T00:00:00,0,0,0,0
ΚΑΡΠΑΘΟΥ,1204,0,0,0,0,2021-01-03T00:00:00,0,0,0,0
ΚΑΣΤΟΡΙΑΣ,302,0,0,0,0,2021-01-03T00:00:00,0,0,0,0
ΚΕΑΣ-ΚΥΘΝΟΥ,1205,0,0,0,0,2021-01-03T00:00:00,0,0,0,0
ΚΕΝΤΡΙΚΟΥ ΤΟΜΕΑ ΑΘΗΝΩΝ,905,166,0,36,166,2021-01-03T00:00:00,867,867,0,867
ΚΕΡΚΥΡΑΣ,603,0,0,0,0,2021-01-03T00:00:00,0,0,0,0
ΚΕΦΑΛΛΗΝΙΑΣ,604,0,0,0,0,2021-01-03T00:00:00,0,0,0,0
ΚΙΛΚΙΣ,203,0,0,0,0,2021-01-03T00:00:00,0,0,0,0
ΚΟΖΑΝΗΣ,303,0,0,0,0,2021-01-03T00:00:00,0,0,0,0
ΚΟΡΙΝΘΙΑΣ,1003,0,0,0,0,2021-01-03T00:00:00,0,0,0,0
ΚΩ,1206,0,0,0,0,2021-01-03T00:00:00,0,0,0,0
ΛΑΚΩΝΙΑΣ,1004,0,0,0,0,2021-01-03T00:00:00,0,0,0,0
ΛΑΡΙΣΑΣ,502,35,0,-10,35,2021-01-03T00:00:00,506,506,0,506
ΛΑΣΙΘΙΟΥ,1302,0,0,0,0,2021-01-03T00:00:00,0,0,0,0
ΛΕΣΒΟΥ,1102,0,0,0,0,2021-01-03T00:00:00,0,0,0,0
ΛΕΥΚΑΔΑΣ,605,0,0,0,0,2021-01-03T00:00:00,0,0,0,0
ΛΗΜΝΟΥ,1103,0,0,0,0,2021-01-03T00:00:00,0,0,0,0
ΜΑΓΝΗΣΙΑΣ,503,0,0,0,0,2021-01-03T00:00:00,0,0,0,0
ΜΕΣΣΗΝΙΑΣ,1005,0,0,0,0,2021-01-03T00:00:00,0,0,0,0
ΜΗΛΟΥ,1207,0,0,0,0,2021-01-03T00:00:00,0,0,0,0
ΜΥΚΟΝΟΥ,1208,0,0,0,0,2021-01-03T00:00:00,0,0,0,0
ΝΑΞΟΥ,1209,0,0,0,0,2021-01-03T00:00:00,0,0,0,0
ΝΗΣΩΝ,906,0,0,0,0,2021-01-03T00:00:00,0,0,0,0
ΝΟΤΙΟΥ ΤΟΜΕΑ ΑΘΗΝΩΝ,907,0,0,0,0,2021-01-03T00:00:00,0,0,0,0
ΞΑΝΘΗΣ,105,0,0,0,0,2021-01-03T00:00:00,0,0,0,0
ΠΑΡΟΥ,1210,0,0,0,0,2021-01-03T00:00:00,0,0,0,0
ΠΕΙΡΑΙΩΣ,908,3,0,3,3,2021-01-03T00:00:00,3,3,0,3
ΠΕΛΛΑΣ,204,0,0,0,0,2021-01-03T00:00:00,0,0,0,0
ΠΙΕΡΙΑΣ,205,0,0,0,0,2021-01-03T00:00:00,0,0,0,0
ΠΡΕΒΕΖΑΣ,404,0,0,0,0,2021-01-03T00:00:00,0,0,0,0
ΡΕΘΥΜΝΟΥ,1303,0,0,0,0,2021-01-03T00:00:00,0,0,0,0
ΡΟΔΟΠΗΣ,106,0,0,0,0,2021-01-03T00:00:00,0,0,0,0
ΡΟΔΟΥ,1211,0,0,0,0,2021-01-03T00:00:00,0,0,0,0
ΣΑΜΟΥ,1104,0,0,0,0,2021-01-03T00:00:00,0,0,0,0
ΣΕΡΡΩΝ,206,0,0,0,0,2021-01-03T00:00:00,0,0,0,0
ΣΠΟΡΑΔΩΝ,504,0,0,0,0,2021-01-03T00:00:00,0,0,0,0
ΣΥΡΟΥ,1212,0,0,0,0,2021-01-03T00:00:00,0,0,0,0
ΤΗΝΟΥ,1213,0,0,0,0,2021-01-03T00:00:00,0,0,0,0
ΤΡΙΚΑΛΩΝ,505,0,0,0,0,2021-01-03T00:00:00,0,0,0,0
ΦΘΙΩΤΙΔΑΣ,804,0,0,0,0,2021-01-03T00:00:00,0,0,0,0
ΦΛΩΡΙΝΑΣ,304,0,0,0,0,2021-01-03T00:00:00,0,0,0,0
ΦΩΚΙΔΑΣ,805,0,0,0,0,2021-01-03T00:00:00,0,0,0,0
ΧΑΛΚΙΔΙΚΗΣ,207,0,0,0,0,2021-01-03T00:00:00,0,0,0,0
ΧΑΝΙΩΝ,1304,0,0,0,0,2021-01-03T00:00:00,0,0,0,0
ΧΙΟΥ,1105,0,0,0,0,2021-01-03T00:00:00,0,0,0,0
ΑΙΤΩΛΟΑΚΑΡΝΑΝΙΑΣ,701,50,0,50,50,2021-01-04T00:00:00,50,50,0,50
ΑΝΑΤΟΛΙΚΗΣ ΑΤΤΙΚΗΣ,901,85,0,30,85,2021-01-04T00:00:00,466,466,0,466
ΑΝΔΡΟΥ,1201,0,0,0,0,2021-01-04T00:00:00,0,0,0,0
ΑΡΓΟΛΙΔΑΣ,1001,0,0,0,0,2021-01-04T00:00:00,0,0,0,0
ΑΡΚΑΔΙΑΣ,1002,0,0,0,0,2021-01-04T00:00:00,0,0,0,0
ΑΡΤΑΣ,401,60,0,40,60,2021-01-04T00:00:00,80,80,0,80
ΑΧΑΪΑΣ,702,270,0,120,270,2021-01-04T00:00:00,836,836,0,836
ΒΟΙΩΤΙΑΣ,801,0,0,0,0,2021-01-04T00:00:00,0,0,0,0
ΒΟΡΕΙΟΥ ΤΟΜΕΑ ΑΘΗΝΩΝ,902,664,0,646,664,2021-01-04T00:00:00,682,682,0,682
ΓΡΕΒΕΝΩΝ,301,0,0,0,0,2021-01-04T00:00:00,0,0,0,0
ΔΡΑΜΑΣ,101,0,0,0,0,2021-01-04T00:00:00,0,0,0,0
ΔΥΤΙΚΗΣ ΑΤΤΙΚΗΣ,903,65,0,65,65,2021-01-04T00:00:00,299,299,0,299
ΔΥΤΙΚΟΥ ΤΟΜΕΑ ΑΘΗΝΩΝ,904,150,0,80,150,2021-01-04T00:00:00,535,535,0,535
ΕΒΡΟΥ,102,0,0,0,0,2021-01-04T00:00:00,0,0,0,0
ΕΥΒΟΙΑΣ,802,0,0,0,0,2021-01-04T00:00:00,0,0,0,0
ΕΥΡΥΤΑΝΙΑΣ,803,0,0,0,0,2021-01-04T00:00:00,0,0,0,0
ΖΑΚΥΝΘΟΥ,601,0,0,0,0,2021-01-04T00:00:00,0,0,0,0
ΗΛΕΙΑΣ,703,0,0,0,0,2021-01-04T00:00:00,0,0,0,0
ΗΜΑΘΙΑΣ,201,79,0,79,79,2021-01-04T00:00:00,79,79,0,79
ΗΡΑΚΛΕΙΟΥ,1301,131,0,131,131,2021-01-04T00:00:00,131,131,0,131
ΘΑΣΟΥ,103,0,0,0,0,2021-01-04T00:00:00,0,0,0,0
ΘΕΣΠΡΩΤΙΑΣ,402,0,0,0,0,2021-01-04T00:00:00,0,0,0,0
ΘΕΣΣΑΛΟΝΙΚΗΣ,202,1181,0,1058,1181,2021-01-04T00:00:00,1642,1642,0,1642
ΘΗΡΑΣ,1202,0,0,0,0,2021-01-04T00:00:00,0,0,0,0
ΙΘΑΚΗΣ,602,0,0,0,0,2021-01-04T00:00:00,0,0,0,0
ΙΚΑΡΙΑΣ,1101,0,0,0,0,2021-01-04T00:00:00,0,0,0,0
ΙΩΑΝΝΙΝΩΝ,403,259,0,179,259,2021-01-04T00:00:00,687,687,0,687
ΚΑΒΑΛΑΣ,104,0,0,0,0,2021-01-04T00:00:00,0,0,0,0
ΚΑΛΥΜΝΟΥ,1203,0,0,0,0,2021-01-04T00:00:00,0,0,0,0
ΚΑΡΔΙΤΣΑΣ,501,100,0,100,100,2021-01-04T00:00:00,100,100,0,100
ΚΑΡΠΑΘΟΥ,1204,0,0,0,0,2021-01-04T00:00:00,0,0,0,0
ΚΑΣΤΟΡΙΑΣ,302,0,0,0,0,2021-01-04T00:00:00,0,0,0,0
ΚΕΑΣ-ΚΥΘΝΟΥ,1205,0,0,0,0,2021-01-04T00:00:00,0,0,0,0
ΚΕΝΤΡΙΚΟΥ ΤΟΜΕΑ ΑΘΗΝΩΝ,905,2254,0,2088,2254,2021-01-04T00:00:00,3121,3121,0,3121
ΚΕΡΚΥΡΑΣ,603,0,0,0,0,2021-01-04T00:00:00,0,0,0,0
ΚΕΦΑΛΛΗΝΙΑΣ,604,0,0,0,0,2021-01-04T00:00:00,0,0,0,0
ΚΙΛΚΙΣ,203,0,0,0,0,2021-01-04T00:00:00,0,0,0,0
ΚΟΖΑΝΗΣ,303,124,0,124,124,2021-01-04T00:00:00,124,124,0,124
ΚΟΡΙΝΘΙΑΣ,1003,50,0,50,50,2021-01-04T00:00:00,50,50,0,50
ΚΩ,1206,0,0,0,0,2021-01-04T00:00:00,0,0,0,0
ΛΑΚΩΝΙΑΣ,1004,0,0,0,0,2021-01-04T00:00:00,0,0,0,0
ΛΑΡΙΣΑΣ,502,230,0,195,230,2021-01-04T00:00:00,736,736,0,736
ΛΑΣΙΘΙΟΥ,1302,0,0,0,0,2021-01-04T00:00:00,0,0,0,0
ΛΕΣΒΟΥ,1102,0,0,0,0,2021-01-04T00:00:00,0,0,0,0
ΛΕΥΚΑΔΑΣ,605,0,0,0,0,2021-01-04T00:00:00,0,0,0,0
ΛΗΜΝΟΥ,1103,0,0,0,0,2021-01-04T00:00:00,0,0,0,0
ΜΑΓΝΗΣΙΑΣ,503,0,0,0,0,2021-01-04T00:00:00,0,0,0,0
ΜΕΣΣΗΝΙΑΣ,1005,0,0,0,0,2021-01-04T00:00:00,0,0,0,0
ΜΗΛΟΥ,1207,0,0,0,0,2021-01-04T00:00:00,0,0,0,0
ΜΥΚΟΝΟΥ,1208,0,0,0,0,2021-01-04T00:00:00,0,0,0,0
ΝΑΞΟΥ,1209,0,0,0,0,2021-01-04T00:00:00,0,0,0,0
ΝΗΣΩΝ,906,0,0,0,0,2021-01-04T00:00:00,0,0,0,0
ΝΟΤΙΟΥ ΤΟΜΕΑ ΑΘΗΝΩΝ,907,0,0,0,0,2021-01-04T00:00:00,0,0,0,0
ΞΑΝΘΗΣ,105,0,0,0,0,2021-01-04T00:00:00,0,0,0,0
ΠΑΡΟΥ,1210,0,0,0,0,2021-01-04T00:00:00,0,0,0,0
ΠΕΙΡΑΙΩΣ,908,176,0,173,176,2021-01-04T00:00:00,179,179,0,179
ΠΕΛΛΑΣ,204,146,0,146,146,2021-01-04T00:00:00,146,146,0,146
ΠΙΕΡΙΑΣ,205,94,0,94,94,2021-01-04T00:00:00,94,94,0,94
ΠΡΕΒΕΖΑΣ,404,0,0,0,0,2021-01-04T00:00:00,0,0,0,0
ΡΕΘΥΜΝΟΥ,1303,0,0,0,0,2021-01-04T00:00:00,0,0,0,0
ΡΟΔΟΠΗΣ,106,0,0,0,0,2021-01-04T00:00:00,0,0,0,0
ΡΟΔΟΥ,1211,0,0,0,0,2021-01-04T00:00:00,0,0,0,0
ΣΑΜΟΥ,1104,0,0,0,0,2021-01-04T00:00:00,0,0,0,0
ΣΕΡΡΩΝ,206,0,0,0,0,2021-01-04T00:00:00,0,0,0,0
ΣΠΟΡΑΔΩΝ,504,0,0,0,0,2021-01-04T00:00:00,0,0,0,0
ΣΥΡΟΥ,1212,0,0,0,0,2021-01-04T00:00:00,0,0,0,0
ΤΗΝΟΥ,1213,0,0,0,0,2021-01-04T00:00:00,0,0,0,0
ΤΡΙΚΑΛΩΝ,505,140,0,140,140,2021-01-04T00:00:00,140,140,0,140
ΦΘΙΩΤΙΔΑΣ,804,0,0,0,0,2021-01-04T00:00:00,0,0,0,0
ΦΛΩΡΙΝΑΣ,304,0,0,0,0,2021-01-04T00:00:00,0,0,0,0
ΦΩΚΙΔΑΣ,805,0,0,0,0,2021-01-04T00:00:00,0,0,0,0
ΧΑΛΚΙΔΙΚΗΣ,207,0,0,0,0,2021-01-04T00:00:00,0,0,0,0
ΧΑΝΙΩΝ,1304,150,0,150,150,2021-01-04T00:00:00,150,150,0,150
ΧΙΟΥ,1105,0,0,0,0,2021-01-04T00:00:00,0,0,0,0
ΑΙΤΩΛΟΑΚΑΡΝΑΝΙΑΣ,701,50,0,0,50,2021-01-05T00:00:00,100,100,0,100
ΑΝΑΤΟΛΙΚΗΣ ΑΤΤΙΚΗΣ,901,40,0,-45,40,2021-01-05T00:00:00,506,506,0,506
ΑΝΔΡΟΥ,1201,0,0,0,0,2021-01-05T00:00:00,0,0,0,0
ΑΡΓΟΛΙΔΑΣ,1001,0,0,0,0,2021-01-05T00:00:00,0,0,0,0
ΑΡΚΑΔΙΑΣ,1002,0,0,0,0,2021-01-05T00:00:00,0,0,0,0
ΑΡΤΑΣ,401,95,0,35,95,2021-01-05T00:00:00,175,175,0,175
ΑΧΑΪΑΣ,702,380,0,110,380,2021-01-05T00:00:00,1216,1216,0,1216
ΒΟΙΩΤΙΑΣ,801,0,0,0,0,2021-01-05T00:00:00,0,0,0,0
ΒΟΡΕΙΟΥ ΤΟΜΕΑ ΑΘΗΝΩΝ,902,637,0,-27,637,2021-01-05T00:00:00,1319,1319,0,1319
ΓΡΕΒΕΝΩΝ,301,0,0,0,0,2021-01-05T00:00:00,0,0,0,0
ΔΡΑΜΑΣ,101,0,0,0,0,2021-01-05T00:00:00,0,0,0,0
ΔΥΤΙΚΗΣ ΑΤΤΙΚΗΣ,903,40,0,-25,40,2021-01-05T00:00:00,339,339,0,339
ΔΥΤΙΚΟΥ ΤΟΜΕΑ ΑΘΗΝΩΝ,904,150,0,0,150,2021-01-05T00:00:00,685,685,0,685
ΕΒΡΟΥ,102,0,0,0,0,2021-01-05T00:00:00,0,0,0,0
ΕΥΒΟΙΑΣ,802,0,0,0,0,2021-01-05T00:00:00,0,0,0,0
ΕΥΡΥΤΑΝΙΑΣ,803,0,0,0,0,2021-01-05T00:00:00,0,0,0,0
ΖΑΚΥΝΘΟΥ,601,0,0,0,0,2021-01-05T00:00:00,0,0,0,0
ΗΛΕΙΑΣ,703,0,0,0,0,2021-01-05T00:00:00,0,0,0,0
ΗΜΑΘΙΑΣ,201,50,0,-29,50,2021-01-05T00:00:00,129,129,0,129
ΗΡΑΚΛΕΙΟΥ,1301,125,0,-6,125,2021-01-05T00:00:00,256,256,0,256
ΘΑΣΟΥ,103,0,0,0,0,2021-01-05T00:00:00,0,0,0,0
ΘΕΣΠΡΩΤΙΑΣ,402,0,0,0,0,2021-01-05T00:00:00,0,0,0,0
ΘΕΣΣΑΛΟΝΙΚΗΣ,202,1266,0,85,1266,2021-01-05T00:00:00,2908,2908,0,2908
ΘΗΡΑΣ,1202,0,0,0,0,2021-01-05T00:00:00,0,0,0,0
ΙΘΑΚΗΣ,602,0,0,0,0,2021-01-05T00:00:00,0,0,0,0
ΙΚΑΡΙΑΣ,1101,0,0,0,0,2021-01-05T00:00:00,0,0,0,0
ΙΩΑΝΝΙΝΩΝ,403,216,0,-43,216,2021-01-05T00:00:00,903,903,0,903
ΚΑΒΑΛΑΣ,104,0,0,0,0,2021-01-05T00:00:00,0,0,0,0
ΚΑΛΥΜΝΟΥ,1203,0,0,0,0,2021-01-05T00:00:00,0,0,0,0
ΚΑΡΔΙΤΣΑΣ,501,140,0,40,140,2021-01-05T00:00:00,240,240,0,240
ΚΑΡΠΑΘΟΥ,1204,0,0,0,0,2021-01-05T00:00:00,0,0,0,0
ΚΑΣΤΟΡΙΑΣ,302,0,0,0,0,2021-01-05T00:00:00,0,0,0,0
ΚΕΑΣ-ΚΥΘΝΟΥ,1205,0,0,0,0,2021-01-05T00:00:00,0,0,0,0
ΚΕΝΤΡΙΚΟΥ ΤΟΜΕΑ ΑΘΗΝΩΝ,905,2208,0,-46,2208,2021-01-05T00:00:00,5329,5329,0,5329
ΚΕΡΚΥΡΑΣ,603,0,0,0,0,2021-01-05T00:00:00,0,0,0,0
ΚΕΦΑΛΛΗΝΙΑΣ,604,0,0,0,0,2021-01-05T00:00:00,0,0,0,0
ΚΙΛΚΙΣ,203,0,0,0,0,2021-01-05T00:00:00,0,0,0,0
ΚΟΖΑΝΗΣ,303,104,0,-20,104,2021-01-05T00:00:00,228,228,0,228
ΚΟΡΙΝΘΙΑΣ,1003,50,0,0,50,2021-01-05T00:00:00,100,100,0,100
ΚΩ,1206,0,0,0,0,2021-01-05T00:00:00,0,0,0,0
ΛΑΚΩΝΙΑΣ,1004,0,0,0,0,2021-01-05T00:00:00,0,0,0,0
ΛΑΡΙΣΑΣ,502,215,0,-15,215,2021-01-05T00:00:00,951,951,0,951
ΛΑΣΙΘΙΟΥ,1302,0,0,0,0,2021-01-05T00:00:00,0,0,0,0
ΛΕΣΒΟΥ,1102,0,0,0,0,2021-01-05T00:00:00,0,0,0,0
ΛΕΥΚΑΔΑΣ,605,0,0,0,0,2021-01-05T00:00:00,0,0,0,0
ΛΗΜΝΟΥ,1103,0,0,0,0,2021-01-05T00:00:00,0,0,0,0
ΜΑΓΝΗΣΙΑΣ,503,0,0,0,0,2021-01-05T00:00:00,0,0,0,0
ΜΕΣΣΗΝΙΑΣ,1005,0,0,0,0,2021-01-05T00:00:00,0,0,0,0
ΜΗΛΟΥ,1207,0,0,0,0,2021-01-05T00:00:00,0,0,0,0
ΜΥΚΟΝΟΥ,1208,0,0,0,0,2021-01-05T00:00:00,0,0,0,0
ΝΑΞΟΥ,1209,0,0,0,0,2021-01-05T00:00:00,0,0,0,0
ΝΗΣΩΝ,906,0,0,0,0,2021-01-05T00:00:00,0,0,0,0
ΝΟΤΙΟΥ ΤΟΜΕΑ ΑΘΗΝΩΝ,907,0,0,0,0,2021-01-05T00:00:00,0,0,0,0
ΞΑΝΘΗΣ,105,0,0,0,0,2021-01-05T00:00:00,0,0,0,0
ΠΑΡΟΥ,1210,0,0,0,0,2021-01-05T00:00:00,0,0,0,0
ΠΕΙΡΑΙΩΣ,908,173,0,-3,173,2021-01-05T00:00:00,352,352,0,352
ΠΕΛΛΑΣ,204,65,0,-81,65,2021-01-05T00:00:00,211,211,0,211
ΠΙΕΡΙΑΣ,205,95,0,1,95,2021-01-05T00:00:00,189,189,0,189
ΠΡΕΒΕΖΑΣ,404,0,0,0,0,2021-01-05T00:00:00,0,0,0,0
ΡΕΘΥΜΝΟΥ,1303,0,0,0,0,2021-01-05T00:00:00,0,0,0,0
ΡΟΔΟΠΗΣ,106,0,0,0,0,2021-01-05T00:00:00,0,0,0,0
ΡΟΔΟΥ,1211,0,0,0,0,2021-01-05T00:00:00,0,0,0,0
ΣΑΜΟΥ,1104,0,0,0,0,2021-01-05T00:00:00,0,0,0,0
ΣΕΡΡΩΝ,206,0,0,0,0,2021-01-05T00:00:00,0,0,0,0
ΣΠΟΡΑΔΩΝ,504,0,0,0,0,2021-01-05T00:00:00,0,0,0,0
ΣΥΡΟΥ,1212,0,0,0,0,2021-01-05T00:00:00,0,0,0,0
ΤΗΝΟΥ,1213,0,0,0,0,2021-01-05T00:00:00,0,0,0,0
ΤΡΙΚΑΛΩΝ,505,60,0,-80,60,2021-01-05T00:00:00,200,200,0,200
ΦΘΙΩΤΙΔΑΣ,804,0,0,0,0,2021-01-05T00:00:00,0,0,0,0
ΦΛΩΡΙΝΑΣ,304,0,0,0,0,2021-01-05T00:00:00,0,0,0,0
ΦΩΚΙΔΑΣ,805,0,0,0,0,2021-01-05T00:00:00,0,0,0,0
ΧΑΛΚΙΔΙΚΗΣ,207,0,0,0,0,2021-01-05T00:00:00,0,0,0,0
ΧΑΝΙΩΝ,1304,145,0,-5,145,2021-01-05T00:00:00,295,295,0,295
ΧΙΟΥ,1105,0,0,0,0,2021-01-05T00:00:00,0,0,0,0
ΑΙΤΩΛΟΑΚΑΡΝΑΝΙΑΣ,701,50,0,0,50,2021-01-06T00:00:00,150,150,0,150
ΑΝΑΤΟΛΙΚΗΣ ΑΤΤΙΚΗΣ,901,60,0,20,60,2021-01-06T00:00:00,566,566,0,566
ΑΝΔΡΟΥ,1201,0,0,0,0,2021-01-06T00:00:00,0,0,0,0
ΑΡΓΟΛΙΔΑΣ,1001,0,0,0,0,2021-01-06T00:00:00,0,0,0,0
ΑΡΚΑΔΙΑΣ,1002,0,0,0,0,2021-01-06T00:00:00,0,0,0,0
ΑΡΤΑΣ,401,15,0,-80,15,2021-01-06T00:00:00,190,190,0,190
ΑΧΑΪΑΣ,702,40,0,-340,40,2021-01-06T00:00:00,1256,1256,0,1256
ΒΟΙΩΤΙΑΣ,801,0,0,0,0,2021-01-06T00:00:00,0,0,0,0
ΒΟΡΕΙΟΥ ΤΟΜΕΑ ΑΘΗΝΩΝ,902,439,0,-198,439,2021-01-06T00:00:00,1758,1758,0,1758
ΓΡΕΒΕΝΩΝ,301,0,0,0,0,2021-01-06T00:00:00,0,0,0,0
ΔΡΑΜΑΣ,101,0,0,0,0,2021-01-06T00:00:00,0,0,0,0
ΔΥΤΙΚΗΣ ΑΤΤΙΚΗΣ,903,0,0,-40,0,2021-01-06T00:00:00,339,339,0,339
ΔΥΤΙΚΟΥ ΤΟΜΕΑ ΑΘΗΝΩΝ,904,160,0,10,160,2021-01-06T00:00:00,845,845,0,845
ΕΒΡΟΥ,102,0,0,0,0,2021-01-06T00:00:00,0,0,0,0
ΕΥΒΟΙΑΣ,802,0,0,0,0,2021-01-06T00:00:00,0,0,0,0
ΕΥΡΥΤΑΝΙΑΣ,803,0,0,0,0,2021-01-06T00:00:00,0,0,0,0
ΖΑΚΥΝΘΟΥ,601,0,0,0,0,2021-01-06T00:00:00,0,0,0,0
ΗΛΕΙΑΣ,703,0,0,0,0,2021-01-06T00:00:00,0,0,0,0
ΗΜΑΘΙΑΣ,201,30,0,-20,30,2021-01-06T00:00:00,159,159,0,159
ΗΡΑΚΛΕΙΟΥ,1301,120,0,-5,120,2021-01-06T00:00:00,376,376,0,376
ΘΑΣΟΥ,103,0,0,0,0,2021-01-06T00:00:00,0,0,0,0
ΘΕΣΠΡΩΤΙΑΣ,402,0,0,0,0,2021-01-06T00:00:00,0,0,0,0
ΘΕΣΣΑΛΟΝΙΚΗΣ,202,550,0,-716,550,2021-01-06T00:00:00,3458,3458,0,3458
ΘΗΡΑΣ,1202,0,0,0,0,2021-01-06T00:00:00,0,0,0,0
ΙΘΑΚΗΣ,602,0,0,0,0,2021-01-06T00:00:00,0,0,0,0
ΙΚΑΡΙΑΣ,1101,0,0,0,0,2021-01-06T00:00:00,0,0,0,0
ΙΩΑΝΝΙΝΩΝ,403,160,0,-56,160,2021-01-06T00:00:00,1063,1063,0,1063
ΚΑΒΑΛΑΣ,104,0,0,0,0,2021-01-06T00:00:00,0,0,0,0
ΚΑΛΥΜΝΟΥ,1203,0,0,0,0,2021-01-06T00:00:00,0,0,0,0
ΚΑΡΔΙΤΣΑΣ,501,105,0,-35,105,2021-01-06T00:00:00,345,345,0,345
ΚΑΡΠΑΘΟΥ,1204,0,0,0,0,2021-01-06T00:00:00,0,0,0,0
ΚΑΣΤΟΡΙΑΣ,302,0,0,0,0,2021-01-06T00:00:00,0,0,0,0
ΚΕΑΣ-ΚΥΘΝΟΥ,1205,0,0,0,0,2021-01-06T00:00:00,0,0,0,0
ΚΕΝΤΡΙΚΟΥ ΤΟΜΕΑ ΑΘΗΝΩΝ,905,1509,0,-699,1509,2021-01-06T00:00:00,6838,6838,0,6838
ΚΕΡΚΥΡΑΣ,603,0,0,0,0,2021-01-06T00:00:00,0,0,0,0
ΚΕΦΑΛΛΗΝΙΑΣ,604,0,0,0,0,2021-01-06T00:00:00,0,0,0,0
ΚΙΛΚΙΣ,203,0,0,0,0,2021-01-06T00:00:00,0,0,0,0
ΚΟΖΑΝΗΣ,303,90,0,-14,90,2021-01-06T00:00:00,318,318,0,318
ΚΟΡΙΝΘΙΑΣ,1003,50,0,0,50,2021-01-06T00:00:00,150,150,0,150
ΚΩ,1206,0,0,0,0,2021-01-06T00:00:00,0,0,0,0
ΛΑΚΩΝΙΑΣ,1004,0,0,0,0,2021-01-06T00:00:00,0,0,0,0
ΛΑΡΙΣΑΣ,502,100,0,-115,100,2021-01-06T00:00:00,1051,1051,0,1051
ΛΑΣΙΘΙΟΥ,1302,0,0,0,0,2021-01-06T00:00:00,0,0,0,0
ΛΕΣΒΟΥ,1102,0,0,0,0,2021-01-06T00:00:00,0,0,0,0
ΛΕΥΚΑΔΑΣ,605,0,0,0,0,2021-01-06T00:00:00,0,0,0,0
ΛΗΜΝΟΥ,1103,0,0,0,0,2021-01-06T00:00:00,0,0,0,0
ΜΑΓΝΗΣΙΑΣ,503,0,0,0,0,2021-01-06T00:00:00,0,0,0,0
ΜΕΣΣΗΝΙΑΣ,1005,0,0,0,0,2021-01-06T00:00:00,0,0,0,0
ΜΗΛΟΥ,1207,0,0,0,0,2021-01-06T00:00:00,0,0,0,0
ΜΥΚΟΝΟΥ,1208,0,0,0,0,2021-01-06T00:00:00,0,0,0,0
ΝΑΞΟΥ,1209,0,0,0,0,2021-01-06T00:00:00,0,0,0,0
ΝΗΣΩΝ,906,0,0,0,0,2021-01-06T00:00:00,0,0,0,0
ΝΟΤΙΟΥ ΤΟΜΕΑ ΑΘΗΝΩΝ,907,0,0,0,0,2021-01-06T00:00:00,0,0,0,0
ΞΑΝΘΗΣ,105,0,0,0,0,2021-01-06T00:00:00,0,0,0,0
ΠΑΡΟΥ,1210,0,0,0,0,2021-01-06T00:00:00,0,0,0,0
ΠΕΙΡΑΙΩΣ,908,97,0,-76,97,2021-01-06T00:00:00,449,449,0,449
ΠΕΛΛΑΣ,204,100,0,35,100,2021-01-06T00:00:00,311,311,0,311
ΠΙΕΡΙΑΣ,205,70,0,-25,70,2021-01-06T00:00:00,259,259,0,259
ΠΡΕΒΕΖΑΣ,404,0,0,0,0,2021-01-06T00:00:00,0,0,0,0
ΡΕΘΥΜΝΟΥ,1303,0,0,0,0,2021-01-06T00:00:00,0,0,0,0
ΡΟΔΟΠΗΣ,106,0,0,0,0,2021-01-06T00:00:00,0,0,0,0
ΡΟΔΟΥ,1211,0,0,0,0,2021-01-06T00:00:00,0,0,0,0
ΣΑΜΟΥ,1104,0,0,0,0,2021-01-06T00:00:00,0,0,0,0
ΣΕΡΡΩΝ,206,0,0,0,0,2021-01-06T00:00:00,0,0,0,0
ΣΠΟΡΑΔΩΝ,504,0,0,0,0,2021-01-06T00:00:00,0,0,0,0
ΣΥΡΟΥ,1212,0,0,0,0,2021-01-06T00:00:00,0,0,0,0
ΤΗΝΟΥ,1213,0,0,0,0,2021-01-06T00:00:00,0,0,0,0
ΤΡΙΚΑΛΩΝ,505,85,0,25,85,2021-01-06T00:00:00,285,285,0,285
ΦΘΙΩΤΙΔΑΣ,804,0,0,0,0,2021-01-06T00:00:00,0,0,0,0
ΦΛΩΡΙΝΑΣ,304,0,0,0,0,2021-01-06T00:00:00,0,0,0,0
ΦΩΚΙΔΑΣ,805,0,0,0,0,2021-01-06T00:00:00,0,0,0,0
ΧΑΛΚΙΔΙΚΗΣ,207,0,0,0,0,2021-01-06T00:00:00,0,0,0,0
ΧΑΝΙΩΝ,1304,155,0,10,155,2021-01-06T00:00:00,450,450,0,450
ΧΙΟΥ,1105,0,0,0,0,2021-01-06T00:00:00,0,0,0,0
ΑΙΤΩΛΟΑΚΑΡΝΑΝΙΑΣ,701,133,88,29,221,2021-02-11T00:00:00,3609,3609,1092,4701
ΑΝΑΤΟΛΙΚΗΣ ΑΤΤΙΚΗΣ,901,160,313,-8,473,2021-02-11T00:00:00,9140,9140,1303,10443
ΑΝΔΡΟΥ,1201,0,0,0,0,2021-02-11T00:00:00,263,263,1,264
ΑΡΓΟΛΙΔΑΣ,1001,14,177,11,191,2021-02-11T00:00:00,2819,2819,865,3684
ΑΡΚΑΔΙΑΣ,1002,11,139,24,150,2021-02-11T00:00:00,2754,2754,844,3598
ΑΡΤΑΣ,401,19,131,-6,150,2021-02-11T00:00:00,2966,2966,893,3859
ΑΧΑΪΑΣ,702,40,413,-25,453,2021-02-11T00:00:00,9536,9536,3363,12899
ΒΟΙΩΤΙΑΣ,801,19,143,-5,162,2021-02-11T00:00:00,2619,2619,756,3375
ΒΟΡΕΙΟΥ ΤΟΜΕΑ ΑΘΗΝΩΝ,902,978,2707,1555,3685,2021-02-11T00:00:00,42601,42601,18969,61570
ΓΡΕΒΕΝΩΝ,301,36,48,-18,84,2021-02-11T00:00:00,1119,1119,364,1483
ΔΡΑΜΑΣ,101,49,180,9,229,2021-02-11T00:00:00,3031,3031,843,3874
ΔΥΤΙΚΗΣ ΑΤΤΙΚΗΣ,903,3,159,36,162,2021-02-11T00:00:00,2969,2969,861,3830
ΔΥΤΙΚΟΥ ΤΟΜΕΑ ΑΘΗΝΩΝ,904,539,491,-161,1030,2021-02-11T00:00:00,16345,16345,3959,20304
ΕΒΡΟΥ,102,66,289,1,355,2021-02-11T00:00:00,5076,5076,2016,7092
ΕΥΒΟΙΑΣ,802,23,342,-55,365,2021-02-11T00:00:00,5675,5675,1681,7356
ΕΥΡΥΤΑΝΙΑΣ,803,2,28,-6,30,2021-02-11T00:00:00,646,646,267,913
ΖΑΚΥΝΘΟΥ,601,1,95,-6,96,2021-02-11T00:00:00,1297,1297,429,1726
ΗΛΕΙΑΣ,703,31,207,56,238,2021-02-11T00:00:00,3642,3642,1117,4759
ΗΜΑΘΙΑΣ,201,58,204,4,262,2021-02-11T00:00:00,4004,4004,1105,5109
ΗΡΑΚΛΕΙΟΥ,1301,53,524,-21,577,2021-02-11T00:00:00,9084,9084,4215,13299
ΘΑΣΟΥ,103,0,0,-6,0,2021-02-11T00:00:00,405,405,14,419
ΘΕΣΠΡΩΤΙΑΣ,402,39,93,-17,132,2021-02-11T00:00:00,2143,2143,566,2709
ΘΕΣΣΑΛΟΝΙΚΗΣ,202,818,1391,-132,2209,2021-02-11T00:00:00,39427,39427,14762,54189
ΘΗΡΑΣ,1202,6,24,6,30,2021-02-11T00:00:00,333,333,104,437
ΙΘΑΚΗΣ,602,0,0,0,0,2021-02-11T00:00:00,0,0,0,0
ΙΚΑΡΙΑΣ,1101,1,23,6,24,2021-02-11T00:00:00,685,685,101,786
ΙΩΑΝΝΙΝΩΝ,403,128,243,-3,371,2021-02-11T00:00:00,7464,7464,3428,10892
ΚΑΒΑΛΑΣ,104,62,218,28,280,2021-02-11T00:00:00,4034,4034,1109,5143
ΚΑΛΥΜΝΟΥ,1203,7,59,30,66,2021-02-11T00:00:00,690,690,239,929
ΚΑΡΔΙΤΣΑΣ,501,19,197,-29,216,2021-02-11T00:00:00,3880,3880,1117,4997
ΚΑΡΠΑΘΟΥ,1204,0,18,6,18,2021-02-11T00:00:00,252,252,45,297
ΚΑΣΤΟΡΙΑΣ,302,28,93,1,121,2021-02-11T00:00:00,1943,1943,521,2464
ΚΕΑΣ-ΚΥΘΝΟΥ,1205,6,0,6,6,2021-02-11T00:00:00,6,6,0,6
ΚΕΝΤΡΙΚΟΥ ΤΟΜΕΑ ΑΘΗΝΩΝ,905,1777,1529,-99,3306,2021-02-11T00:00:00,57825,57825,23321,81146
ΚΕΡΚΥΡΑΣ,603,33,230,22,263,2021-02-11T00:00:00,3061,3061,870,3931
ΚΕΦΑΛΛΗΝΙΑΣ,604,5,113,-18,118,2021-02-11T00:00:00,1634,1634,609,2243
ΚΙΛΚΙΣ,203,99,183,-31,282,2021-02-11T00:00:00,2876,2876,804,3680
ΚΟΖΑΝΗΣ,303,184,140,24,324,2021-02-11T00:00:00,4166,4166,1142,5308
ΚΟΡΙΝΘΙΑΣ,1003,69,105,24,174,2021-02-11T00:00:00,2839,2839,551,3390
ΚΩ,1206,0,42,-24,42,2021-02-11T00:00:00,927,927,290,1217
ΛΑΚΩΝΙΑΣ,1004,5,162,5,167,2021-02-11T00:00:00,2814,2814,917,3731
ΛΑΡΙΣΑΣ,502,158,215,1,373,2021-02-11T00:00:00,7287,7287,2492,9779
ΛΑΣΙΘΙΟΥ,1302,20,226,-11,246,2021-02-11T00:00:00,3910,3910,1252,5162
ΛΕΣΒΟΥ,1102,3,179,20,182,2021-02-11T00:00:00,2560,2560,771,3331
ΛΕΥΚΑΔΑΣ,605,6,60,-73,66,2021-02-11T00:00:00,1335,1335,273,1608
ΛΗΜΝΟΥ,1103,4,2,-42,6,2021-02-11T00:00:00,757,757,261,1018
ΜΑΓΝΗΣΙΑΣ,503,118,117,50,235,2021-02-11T00:00:00,4236,4236,906,5142
ΜΕΣΣΗΝΙΑΣ,1005,36,225,4,261,2021-02-11T00:00:00,4821,4821,1160,5981
ΜΗΛΟΥ,1207,18,0,-6,18,2021-02-11T00:00:00,230,230,2,232
ΜΥΚΟΝΟΥ,1208,0,0,0,0,2021-02-11T00:00:00,144,144,0,144
ΝΑΞΟΥ,1209,2,28,0,30,2021-02-11T00:00:00,436,436,126,562
ΝΗΣΩΝ,906,34,8,-6,42,2021-02-11T00:00:00,1630,1630,84,1714
ΝΟΤΙΟΥ ΤΟΜΕΑ ΑΘΗΝΩΝ,907,267,256,-28,523,2021-02-11T00:00:00,7485,7485,1964,9449
ΞΑΝΘΗΣ,105,17,116,-18,133,2021-02-11T00:00:00,2299,2299,890,3189
ΠΑΡΟΥ,1210,0,0,-6,0,2021-02-11T00:00:00,286,286,2,288
ΠΕΙΡΑΙΩΣ,908,231,485,-2,716,2021-02-11T00:00:00,14357,14357,4062,18419
ΠΕΛΛΑΣ,204,106,227,16,333,2021-02-11T00:00:00,4904,4904,1103,6007
ΠΙΕΡΙΑΣ,205,101,101,-20,202,2021-02-11T00:00:00,3615,3615,721,4336
ΠΡΕΒΕΖΑΣ,404,5,61,9,66,2021-02-11T00:00:00,1096,1096,516,1612
ΡΕΘΥΜΝΟΥ,1303,13,137,-24,150,2021-02-11T00:00:00,2383,2383,818,3201
ΡΟΔΟΠΗΣ,106,70,98,12,168,2021-02-11T00:00:00,1928,1928,571,2499
ΡΟΔΟΥ,1211,66,91,25,157,2021-02-11T00:00:00,2425,2425,690,3115
ΣΑΜΟΥ,1104,0,60,12,60,2021-02-11T00:00:00,881,881,337,1218
ΣΕΡΡΩΝ,206,88,133,-1,221,2021-02-11T00:00:00,3118,3118,1011,4129
ΣΠΟΡΑΔΩΝ,504,16,2,0,18,2021-02-11T00:00:00,235,235,5,240
ΣΥΡΟΥ,1212,0,48,-6,48,2021-02-11T00:00:00,871,871,282,1153
ΤΗΝΟΥ,1213,0,0,0,0,2021-02-11T00:00:00,280,280,1,281
ΤΡΙΚΑΛΩΝ,505,69,208,12,277,2021-02-11T00:00:00,4236,4236,1208,5444
ΦΘΙΩΤΙΔΑΣ,804,56,201,23,257,2021-02-11T00:00:00,3301,3301,1151,4452
ΦΛΩΡΙΝΑΣ,304,16,103,29,119,2021-02-11T00:00:00,1643,1643,479,2122
ΦΩΚΙΔΑΣ,805,7,49,4,56,2021-02-11T00:00:00,971,971,268,1239
ΧΑΛΚΙΔΙΚΗΣ,207,71,116,1,187,2021-02-11T00:00:00,2341,2341,529,2870
ΧΑΝΙΩΝ,1304,52,344,-13,396,2021-02-11T00:00:00,6646,6646,1817,8463
ΧΙΟΥ,1105,217,56,43,273,2021-02-11T00:00:00,1554,1554,411,1965
ΑΙΤΩΛΟΑΚΑΡΝΑΝΙΑΣ,701,108,109,-4,217,2021-02-12T00:00:00,3717,3717,1201,4918
ΑΝΑΤΟΛΙΚΗΣ ΑΤΤΙΚΗΣ,901,139,387,53,526,2021-02-12T00:00:00,9279,9279,1690,10969
ΑΝΔΡΟΥ,1201,0,0,0,0,2021-02-12T00:00:00,263,263,1,264
ΑΡΓΟΛΙΔΑΣ,1001,7,161,-23,168,2021-02-12T00:00:00,2826,2826,1026,3852
ΑΡΚΑΔΙΑΣ,1002,14,142,6,156,2021-02-12T00:00:00,2768,2768,986,3754
ΑΡΤΑΣ,401,28,152,30,180,2021-02-12T00:00:00,2994,2994,1045,4039
ΑΧΑΪΑΣ,702,28,497,72,525,2021-02-12T00:00:00,9564,9564,3860,13424
ΒΟΙΩΤΙΑΣ,801,15,147,0,162,2021-02-12T00:00:00,2634,2634,903,3537
ΒΟΡΕΙΟΥ ΤΟΜΕΑ ΑΘΗΝΩΝ,902,993,2671,-21,3664,2021-02-12T00:00:00,43594,43594,21640,65234
ΓΡΕΒΕΝΩΝ,301,28,50,-6,78,2021-02-12T00:00:00,1147,1147,414,1561
ΔΡΑΜΑΣ,101,51,176,-2,227,2021-02-12T00:00:00,3082,3082,1019,4101
ΔΥΤΙΚΗΣ ΑΤΤΙΚΗΣ,903,9,255,102,264,2021-02-12T00:00:00,2978,2978,1116,4094
ΔΥΤΙΚΟΥ ΤΟΜΕΑ ΑΘΗΝΩΝ,904,336,678,-16,1014,2021-02-12T00:00:00,16681,16681,4637,21318
ΕΒΡΟΥ,102,58,291,-6,349,2021-02-12T00:00:00,5134,5134,2307,7441
ΕΥΒΟΙΑΣ,802,24,292,-49,316,2021-02-12T00:00:00,5699,5699,1973,7672
ΕΥΡΥΤΑΝΙΑΣ,803,7,35,12,42,2021-02-12T00:00:00,653,653,302,955
ΖΑΚΥΝΘΟΥ,601,3,80,-13,83,2021-02-12T00:00:00,1300,1300,509,1809
ΗΛΕΙΑΣ,703,24,192,-22,216,2021-02-12T00:00:00,3666,3666,1309,4975
ΗΜΑΘΙΑΣ,201,70,214,22,284,2021-02-12T00:00:00,4074,4074,1319,5393
ΗΡΑΚΛΕΙΟΥ,1301,15,531,-31,546,2021-02-12T00:00:00,9099,9099,4746,13845
ΘΑΣΟΥ,103,10,2,12,12,2021-02-12T00:00:00,415,415,16,431
ΘΕΣΠΡΩΤΙΑΣ,402,8,120,-4,128,2021-02-12T00:00:00,2151,2151,686,2837
ΘΕΣΣΑΛΟΝΙΚΗΣ,202,710,1892,393,2602,2021-02-12T00:00:00,40137,40137,16654,56791
ΘΗΡΑΣ,1202,15,21,6,36,2021-02-12T00:00:00,348,348,125,473
ΙΘΑΚΗΣ,602,59,0,59,59,2021-02-12T00:00:00,59,59,0,59
ΙΚΑΡΙΑΣ,1101,4,25,5,29,2021-02-12T00:00:00,689,689,126,815
ΙΩΑΝΝΙΝΩΝ,403,23,384,36,407,2021-02-12T00:00:00,7487,7487,3812,11299
ΚΑΒΑΛΑΣ,104,63,221,4,284,2021-02-12T00:00:00,4097,4097,1330,5427
ΚΑΛΥΜΝΟΥ,1203,2,58,-6,60,2021-02-12T00:00:00,692,692,297,989
ΚΑΡΔΙΤΣΑΣ,501,27,248,59,275,2021-02-12T00:00:00,3907,3907,1365,5272
ΚΑΡΠΑΘΟΥ,1204,5,25,12,30,2021-02-12T00:00:00,257,257,70,327
ΚΑΣΤΟΡΙΑΣ,302,13,107,-1,120,2021-02-12T00:00:00,1956,1956,628,2584
ΚΕΑΣ-ΚΥΘΝΟΥ,1205,12,0,6,12,2021-02-12T00:00:00,18,18,0,18
ΚΕΝΤΡΙΚΟΥ ΤΟΜΕΑ ΑΘΗΝΩΝ,905,1239,1780,-287,3019,2021-02-12T00:00:00,59064,59064,25101,84165
ΚΕΡΚΥΡΑΣ,603,39,230,6,269,2021-02-12T00:00:00,3100,3100,1100,4200
ΚΕΦΑΛΛΗΝΙΑΣ,604,5,127,14,132,2021-02-12T00:00:00,1639,1639,736,2375
ΚΙΛΚΙΣ,203,58,176,-48,234,2021-02-12T00:00:00,2934,2934,980,3914
ΚΟΖΑΝΗΣ,303,90,192,-42,282,2021-02-12T00:00:00,4256,4256,1334,5590
ΚΟΡΙΝΘΙΑΣ,1003,33,135,-6,168,2021-02-12T00:00:00,2872,2872,686,3558
ΚΩ,1206,3,57,18,60,2021-02-12T00:00:00,930,930,347,1277
ΛΑΚΩΝΙΑΣ,1004,8,155,-4,163,2021-02-12T00:00:00,2822,2822,1072,3894
ΛΑΡΙΣΑΣ,502,111,297,35,408,2021-02-12T00:00:00,7398,7398,2789,10187
ΛΑΣΙΘΙΟΥ,1302,12,226,-8,238,2021-02-12T00:00:00,3922,3922,1478,5400
ΛΕΣΒΟΥ,1102,1,143,-38,144,2021-02-12T00:00:00,2561,2561,914,3475
ΛΕΥΚΑΔΑΣ,605,72,61,67,133,2021-02-12T00:00:00,1407,1407,334,1741
ΛΗΜΝΟΥ,1103,8,46,48,54,2021-02-12T00:00:00,765,765,307,1072
ΜΑΓΝΗΣΙΑΣ,503,106,141,12,247,2021-02-12T00:00:00,4342,4342,1047,5389
ΜΕΣΣΗΝΙΑΣ,1005,48,210,-3,258,2021-02-12T00:00:00,4869,4869,1370,6239
ΜΗΛΟΥ,1207,0,0,-18,0,2021-02-12T00:00:00,230,230,2,232
ΜΥΚΟΝΟΥ,1208,0,0,0,0,2021-02-12T00:00:00,144,144,0,144
ΝΑΞΟΥ,1209,4,27,1,31,2021-02-12T00:00:00,440,440,153,593
ΝΗΣΩΝ,906,12,30,0,42,2021-02-12T00:00:00,1642,1642,114,1756
ΝΟΤΙΟΥ ΤΟΜΕΑ ΑΘΗΝΩΝ,907,214,362,53,576,2021-02-12T00:00:00,7699,7699,2326,10025
ΞΑΝΘΗΣ,105,12,120,-1,132,2021-02-12T00:00:00,2311,2311,1010,3321
ΠΑΡΟΥ,1210,0,0,0,0,2021-02-12T00:00:00,286,286,2,288
ΠΕΙΡΑΙΩΣ,908,165,836,285,1001,2021-02-12T00:00:00,14522,14522,4898,19420
ΠΕΛΛΑΣ,204,114,207,-12,321,2021-02-12T00:00:00,5018,5018,1310,6328
ΠΙΕΡΙΑΣ,205,89,156,43,245,2021-02-12T00:00:00,3704,3704,877,4581
ΠΡΕΒΕΖΑΣ,404,5,61,0,66,2021-02-12T00:00:00,1101,1101,577,1678
ΡΕΘΥΜΝΟΥ,1303,7,125,-18,132,2021-02-12T00:00:00,2390,2390,943,3333
ΡΟΔΟΠΗΣ,106,81,95,8,176,2021-02-12T00:00:00,2009,2009,666,2675
ΡΟΔΟΥ,1211,59,85,-13,144,2021-02-12T00:00:00,2484,2484,775,3259
ΣΑΜΟΥ,1104,5,55,0,60,2021-02-12T00:00:00,886,886,392,1278
ΣΕΡΡΩΝ,206,83,146,8,229,2021-02-12T00:00:00,3201,3201,1157,4358
ΣΠΟΡΑΔΩΝ,504,0,0,-18,0,2021-02-12T00:00:00,235,235,5,240
ΣΥΡΟΥ,1212,0,60,12,60,2021-02-12T00:00:00,871,871,342,1213
ΤΗΝΟΥ,1213,0,0,0,0,2021-02-12T00:00:00,280,280,1,281
ΤΡΙΚΑΛΩΝ,505,60,251,34,311,2021-02-12T00:00:00,4296,4296,1459,5755
ΦΘΙΩΤΙΔΑΣ,804,65,217,25,282,2021-02-12T00:00:00,3366,3366,1368,4734
ΦΛΩΡΙΝΑΣ,304,6,108,-5,114,2021-02-12T00:00:00,1649,1649,587,2236
ΦΩΚΙΔΑΣ,805,1,60,5,61,2021-02-12T00:00:00,972,972,328,1300
ΧΑΛΚΙΔΙΚΗΣ,207,27,129,-31,156,2021-02-12T00:00:00,2368,2368,658,3026
ΧΑΝΙΩΝ,1304,40,338,-18,378,2021-02-12T00:00:00,6686,6686,2155,8841
ΧΙΟΥ,1105,159,66,-48,225,2021-02-12T00:00:00,1713,1713,477,2190
ΑΙΤΩΛΟΑΚΑΡΝΑΝΙΑΣ,701,111,135,29,246,2021-02-13T00:00:00,3828,3828,1336,5164
ΑΝΑΤΟΛΙΚΗΣ ΑΤΤΙΚΗΣ,901,108,400,-18,508,2021-02-13T00:00:00,9387,9387,2090,11477
ΑΝΔΡΟΥ,1201,0,0,0,0,2021-02-13T00:00:00,263,263,1,264
ΑΡΓΟΛΙΔΑΣ,1001,45,129,6,174,2021-02-13T00:00:00,2871,2871,1155,4026
ΑΡΚΑΔΙΑΣ,1002,13,167,24,180,2021-02-13T00:00:00,2781,2781,1153,3934
ΑΡΤΑΣ,401,11,174,5,185,2021-02-13T00:00:00,3005,3005,1219,4224
ΑΧΑΪΑΣ,702,32,448,-45,480,2021-02-13T00:00:00,9596,9596,4308,13904
ΒΟΙΩΤΙΑΣ,801,34,127,-1,161,2021-02-13T00:00:00,2668,2668,1030,3698
ΒΟΡΕΙΟΥ ΤΟΜΕΑ ΑΘΗΝΩΝ,902,507,1657,-1500,2164,2021-02-13T00:00:00,44101,44101,23297,67398
ΓΡΕΒΕΝΩΝ,301,11,43,-24,54,2021-02-13T00:00:00,1158,1158,457,1615
ΔΡΑΜΑΣ,101,42,140,-45,182,2021-02-13T00:00:00,3124,3124,1159,4283
ΔΥΤΙΚΗΣ ΑΤΤΙΚΗΣ,903,13,209,-42,222,2021-02-13T00:00:00,2991,2991,1325,4316
ΔΥΤΙΚΟΥ ΤΟΜΕΑ ΑΘΗΝΩΝ,904,256,801,43,1057,2021-02-13T00:00:00,16937,16937,5438,22375
ΕΒΡΟΥ,102,52,248,-49,300,2021-02-13T00:00:00,5186,5186,2555,7741
ΕΥΒΟΙΑΣ,802,18,246,-52,264,2021-02-13T00:00:00,5717,5717,2219,7936
ΕΥΡΥΤΑΝΙΑΣ,803,2,22,-18,24,2021-02-13T00:00:00,655,655,324,979
ΖΑΚΥΝΘΟΥ,601,2,82,1,84,2021-02-13T00:00:00,1302,1302,591,1893
ΗΛΕΙΑΣ,703,17,157,-42,174,2021-02-13T00:00:00,3683,3683,1466,5149
ΗΜΑΘΙΑΣ,201,81,177,-26,258,2021-02-13T00:00:00,4155,4155,1496,5651
ΗΡΑΚΛΕΙΟΥ,1301,36,456,-54,492,2021-02-13T00:00:00,9135,9135,5202,14337
ΘΑΣΟΥ,103,0,0,-12,0,2021-02-13T00:00:00,415,415,16,431
ΘΕΣΠΡΩΤΙΑΣ,402,2,124,-2,126,2021-02-13T00:00:00,2153,2153,810,2963
ΘΕΣΣΑΛΟΝΙΚΗΣ,202,636,1732,-234,2368,2021-02-13T00:00:00,40773,40773,18386,59159
ΘΗΡΑΣ,1202,7,5,-24,12,2021-02-13T00:00:00,355,355,130,485
ΙΘΑΚΗΣ,602,18,0,-41,18,2021-02-13T00:00:00,77,77,0,77
ΙΚΑΡΙΑΣ,1101,1,17,-11,18,2021-02-13T00:00:00,690,690,143,833
ΙΩΑΝΝΙΝΩΝ,403,42,343,-22,385,2021-02-13T00:00:00,7529,7529,4155,11684
ΚΑΒΑΛΑΣ,104,68,207,-9,275,2021-02-13T00:00:00,4165,4165,1537,5702
ΚΑΛΥΜΝΟΥ,1203,0,36,-24,36,2021-02-13T00:00:00,692,692,333,1025
ΚΑΡΔΙΤΣΑΣ,501,33,203,-39,236,2021-02-13T00:00:00,3940,3940,1568,5508
ΚΑΡΠΑΘΟΥ,1204,0,18,-12,18,2021-02-13T00:00:00,257,257,88,345
ΚΑΣΤΟΡΙΑΣ,302,22,86,-12,108,2021-02-13T00:00:00,1978,1978,714,2692
ΚΕΑΣ-ΚΥΘΝΟΥ,1205,0,0,-12,0,2021-02-13T00:00:00,18,18,0,18
ΚΕΝΤΡΙΚΟΥ ΤΟΜΕΑ ΑΘΗΝΩΝ,905,1035,1698,-286,2733,2021-02-13T00:00:00,60099,60099,26799,86898
ΚΕΡΚΥΡΑΣ,603,50,231,12,281,2021-02-13T00:00:00,3150,3150,1331,4481
ΚΕΦΑΛΛΗΝΙΑΣ,604,2,58,-72,60,2021-02-13T00:00:00,1641,1641,794,2435
ΚΙΛΚΙΣ,203,34,104,-96,138,2021-02-13T00:00:00,2968,2968,1084,4052
ΚΟΖΑΝΗΣ,303,49,185,-48,234,2021-02-13T00:00:00,4305,4305,1519,5824
ΚΟΡΙΝΘΙΑΣ,1003,34,128,-6,162,2021-02-13T00:00:00,2906,2906,814,3720
ΚΩ,1206,0,30,-30,30,2021-02-13T00:00:00,930,930,377,1307
ΛΑΚΩΝΙΑΣ,1004,15,140,-8,155,2021-02-13T00:00:00,2837,2837,1212,4049
ΛΑΡΙΣΑΣ,502,127,353,72,480,2021-02-13T00:00:00,7525,7525,3142,10667
ΛΑΣΙΘΙΟΥ,1302,11,200,-27,211,2021-02-13T00:00:00,3933,3933,1678,5611
ΛΕΣΒΟΥ,1102,5,139,0,144,2021-02-13T00:00:00,2566,2566,1053,3619
ΛΕΥΚΑΔΑΣ,605,2,64,-67,66,2021-02-13T00:00:00,1409,1409,398,1807
ΛΗΜΝΟΥ,1103,6,36,-12,42,2021-02-13T00:00:00,771,771,343,1114
ΜΑΓΝΗΣΙΑΣ,503,101,181,35,282,2021-02-13T00:00:00,4443,4443,1228,5671
ΜΕΣΣΗΝΙΑΣ,1005,43,235,20,278,2021-02-13T00:00:00,4912,4912,1605,6517
ΜΗΛΟΥ,1207,0,0,0,0,2021-02-13T00:00:00,230,230,2,232
ΜΥΚΟΝΟΥ,1208,0,0,0,0,2021-02-13T00:00:00,144,144,0,144
ΝΑΞΟΥ,1209,2,16,-13,18,2021-02-13T00:00:00,442,442,169,611
ΝΗΣΩΝ,906,4,17,-21,21,2021-02-13T00:00:00,1646,1646,131,1777
ΝΟΤΙΟΥ ΤΟΜΕΑ ΑΘΗΝΩΝ,907,184,285,-107,469,2021-02-13T00:00:00,7883,7883,2611,10494
ΞΑΝΘΗΣ,105,21,99,-12,120,2021-02-13T00:00:00,2332,2332,1109,3441
ΠΑΡΟΥ,1210,4,2,6,6,2021-02-13T00:00:00,290,290,4,294
ΠΕΙΡΑΙΩΣ,908,83,721,-197,804,2021-02-13T00:00:00,14605,14605,5619,20224
ΠΕΛΛΑΣ,204,97,191,-33,288,2021-02-13T00:00:00,5115,5115,1501,6616
ΠΙΕΡΙΑΣ,205,57,189,1,246,2021-02-13T00:00:00,3761,3761,1066,4827
ΠΡΕΒΕΖΑΣ,404,6,71,11,77,2021-02-13T00:00:00,1107,1107,648,1755
ΡΕΘΥΜΝΟΥ,1303,15,123,6,138,2021-02-13T00:00:00,2405,2405,1066,3471
ΡΟΔΟΠΗΣ,106,95,95,14,190,2021-02-13T00:00:00,2104,2104,761,2865
ΡΟΔΟΥ,1211,28,104,-12,132,2021-02-13T00:00:00,2512,2512,879,3391
ΣΑΜΟΥ,1104,5,37,-18,42,2021-02-13T00:00:00,891,891,429,1320
ΣΕΡΡΩΝ,206,79,143,-7,222,2021-02-13T00:00:00,3280,3280,1300,4580
ΣΠΟΡΑΔΩΝ,504,4,2,6,6,2021-02-13T00:00:00,239,239,7,246
ΣΥΡΟΥ,1212,4,44,-12,48,2021-02-13T00:00:00,875,875,386,1261
ΤΗΝΟΥ,1213,0,0,0,0,2021-02-13T00:00:00,280,280,1,281
ΤΡΙΚΑΛΩΝ,505,105,261,55,366,2021-02-13T00:00:00,4401,4401,1720,6121
ΦΘΙΩΤΙΔΑΣ,804,75,195,-12,270,2021-02-13T00:00:00,3441,3441,1563,5004
ΦΛΩΡΙΝΑΣ,304,11,85,-18,96,2021-02-13T00:00:00,1660,1660,672,2332
ΦΩΚΙΔΑΣ,805,3,61,3,64,2021-02-13T00:00:00,975,975,389,1364
ΧΑΛΚΙΔΙΚΗΣ,207,19,111,-26,130,2021-02-13T00:00:00,2387,2387,769,3156
ΧΑΝΙΩΝ,1304,38,340,0,378,2021-02-13T00:00:00,6724,6724,2495,9219
ΧΙΟΥ,1105,40,55,-130,95,2021-02-13T00:00:00,1753,1753,532,2285
ΑΙΤΩΛΟΑΚΑΡΝΑΝΙΑΣ,701,345,101,200,446,2021-02-15T00:00:00,4173,4173,1437,5610
ΑΝΑΤΟΛΙΚΗΣ ΑΤΤΙΚΗΣ,901,298,343,133,641,2021-02-15T00:00:00,9685,9685,2433,12118
ΑΝΔΡΟΥ,1201,0,0,0,0,2021-02-15T00:00:00,263,263,1,264
ΑΡΓΟΛΙΔΑΣ,1001,112,136,74,248,2021-02-15T00:00:00,2983,2983,1291,4274
ΑΡΚΑΔΙΑΣ,1002,98,161,79,259,2021-02-15T00:00:00,2879,2879,1314,4193
ΑΡΤΑΣ,401,54,154,23,208,2021-02-15T00:00:00,3059,3059,1373,4432
ΑΧΑΪΑΣ,702,250,365,135,615,2021-02-15T00:00:00,9846,9846,4673,14519
ΒΟΙΩΤΙΑΣ,801,97,81,17,178,2021-02-15T00:00:00,2765,2765,1111,3876
ΒΟΡΕΙΟΥ ΤΟΜΕΑ ΑΘΗΝΩΝ,902,3160,1927,2923,5087,2021-02-15T00:00:00,47261,47261,25224,72485
ΓΡΕΒΕΝΩΝ,301,18,45,9,63,2021-02-15T00:00:00,1176,1176,502,1678
ΔΡΑΜΑΣ,101,59,142,19,201,2021-02-15T00:00:00,3183,3183,1301,4484
ΔΥΤΙΚΗΣ ΑΤΤΙΚΗΣ,903,79,110,-33,189,2021-02-15T00:00:00,3070,3070,1435,4505
ΔΥΤΙΚΟΥ ΤΟΜΕΑ ΑΘΗΝΩΝ,904,396,657,-4,1053,2021-02-15T00:00:00,17333,17333,6095,23428
ΕΒΡΟΥ,102,170,225,95,395,2021-02-15T00:00:00,5356,5356,2780,8136
ΕΥΒΟΙΑΣ,802,99,232,67,331,2021-02-15T00:00:00,5816,5816,2451,8267
ΕΥΡΥΤΑΝΙΑΣ,803,7,30,13,37,2021-02-15T00:00:00,662,662,354,1016
ΖΑΚΥΝΘΟΥ,601,4,98,18,102,2021-02-15T00:00:00,1306,1306,689,1995
ΗΛΕΙΑΣ,703,99,189,114,288,2021-02-15T00:00:00,3782,3782,1655,5437
ΗΜΑΘΙΑΣ,201,170,138,50,308,2021-02-15T00:00:00,4325,4325,1634,5959
ΗΡΑΚΛΕΙΟΥ,1301,323,352,183,675,2021-02-15T00:00:00,9458,9458,5554,15012
ΘΑΣΟΥ,103,0,0,0,0,2021-02-15T00:00:00,415,415,16,431
ΘΕΣΠΡΩΤΙΑΣ,402,49,123,46,172,2021-02-15T00:00:00,2202,2202,933,3135
ΘΕΣΣΑΛΟΝΙΚΗΣ,202,1845,1179,656,3024,2021-02-15T00:00:00,42618,42618,19565,62183
ΘΗΡΑΣ,1202,15,19,22,34,2021-02-15T00:00:00,370,370,149,519
ΙΘΑΚΗΣ,602,0,0,-18,0,2021-02-15T00:00:00,77,77,0,77
ΙΚΑΡΙΑΣ,1101,0,29,11,29,2021-02-15T00:00:00,690,690,172,862
ΙΩΑΝΝΙΝΩΝ,403,257,301,173,558,2021-02-15T00:00:00,7786,7786,4456,12242
ΚΑΒΑΛΑΣ,104,116,186,27,302,2021-02-15T00:00:00,4281,4281,1723,6004
ΚΑΛΥΜΝΟΥ,1203,6,44,14,50,2021-02-15T00:00:00,698,698,377,1075
ΚΑΡΔΙΤΣΑΣ,501,172,180,116,352,2021-02-15T00:00:00,4112,4112,1748,5860
ΚΑΡΠΑΘΟΥ,1204,0,18,0,18,2021-02-15T00:00:00,257,257,106,363
ΚΑΣΤΟΡΙΑΣ,302,47,86,25,133,2021-02-15T00:00:00,2025,2025,800,2825
ΚΕΑΣ-ΚΥΘΝΟΥ,1205,13,0,13,13,2021-02-15T00:00:00,31,31,0,31
ΚΕΝΤΡΙΚΟΥ ΤΟΜΕΑ ΑΘΗΝΩΝ,905,2051,1164,482,3215,2021-02-15T00:00:00,62150,62150,27963,90113
ΚΕΡΚΥΡΑΣ,603,86,244,49,330,2021-02-15T00:00:00,3236,3236,1575,4811
ΚΕΦΑΛΛΗΝΙΑΣ,604,6,84,30,90,2021-02-15T00:00:00,1647,1647,878,2525
ΚΙΛΚΙΣ,203,55,137,54,192,2021-02-15T00:00:00,3023,3023,1221,4244
ΚΟΖΑΝΗΣ,303,242,76,84,318,2021-02-15T00:00:00,4547,4547,1595,6142
ΚΟΡΙΝΘΙΑΣ,1003,204,106,148,310,2021-02-15T00:00:00,3110,3110,920,4030
ΚΩ,1206,40,50,60,90,2021-02-15T00:00:00,970,970,427,1397
ΛΑΚΩΝΙΑΣ,1004,123,139,107,262,2021-02-15T00:00:00,2960,2960,1351,4311
ΛΑΡΙΣΑΣ,502,385,314,219,699,2021-02-15T00:00:00,7910,7910,3456,11366
ΛΑΣΙΘΙΟΥ,1302,57,202,48,259,2021-02-15T00:00:00,3990,3990,1880,5870
ΛΕΣΒΟΥ,1102,43,159,58,202,2021-02-15T00:00:00,2609,2609,1212,3821
ΛΕΥΚΑΔΑΣ,605,49,60,43,109,2021-02-15T00:00:00,1458,1458,458,1916
ΛΗΜΝΟΥ,1103,1,41,0,42,2021-02-15T00:00:00,772,772,384,1156
ΜΑΓΝΗΣΙΑΣ,503,145,181,44,326,2021-02-15T00:00:00,4588,4588,1409,5997
ΜΕΣΣΗΝΙΑΣ,1005,114,298,134,412,2021-02-15T00:00:00,5026,5026,1903,6929
ΜΗΛΟΥ,1207,0,0,0,0,2021-02-15T00:00:00,230,230,2,232
ΜΥΚΟΝΟΥ,1208,0,0,0,0,2021-02-15T00:00:00,144,144,0,144
ΝΑΞΟΥ,1209,3,21,6,24,2021-02-15T00:00:00,445,445,190,635
ΝΗΣΩΝ,906,25,19,23,44,2021-02-15T00:00:00,1671,1671,150,1821
ΝΟΤΙΟΥ ΤΟΜΕΑ ΑΘΗΝΩΝ,907,474,273,278,747,2021-02-15T00:00:00,8357,8357,2884,11241
ΞΑΝΘΗΣ,105,43,92,15,135,2021-02-15T00:00:00,2375,2375,1201,3576
ΠΑΡΟΥ,1210,0,0,-6,0,2021-02-15T00:00:00,290,290,4,294
ΠΕΙΡΑΙΩΣ,908,445,585,226,1030,2021-02-15T00:00:00,15050,15050,6204,21254
ΠΕΛΛΑΣ,204,203,151,66,354,2021-02-15T00:00:00,5318,5318,1652,6970
ΠΙΕΡΙΑΣ,205,129,87,-30,216,2021-02-15T00:00:00,3890,3890,1153,5043
ΠΡΕΒΕΖΑΣ,404,98,67,88,165,2021-02-15T00:00:00,1205,1205,715,1920
ΡΕΘΥΜΝΟΥ,1303,92,138,92,230,2021-02-15T00:00:00,2497,2497,1204,3701
ΡΟΔΟΠΗΣ,106,51,93,-46,144,2021-02-15T00:00:00,2155,2155,854,3009
ΡΟΔΟΥ,1211,74,153,95,227,2021-02-15T00:00:00,2586,2586,1032,3618
ΣΑΜΟΥ,1104,25,43,26,68,2021-02-15T00:00:00,916,916,472,1388
ΣΕΡΡΩΝ,206,232,141,151,373,2021-02-15T00:00:00,3512,3512,1441,4953
ΣΠΟΡΑΔΩΝ,504,6,0,0,6,2021-02-15T00:00:00,245,245,7,252
ΣΥΡΟΥ,1212,0,54,6,54,2021-02-15T00:00:00,875,875,440,1315
ΤΗΝΟΥ,1213,0,0,0,0,2021-02-15T00:00:00,280,280,1,281
ΤΡΙΚΑΛΩΝ,505,190,196,20,386,2021-02-15T00:00:00,4591,4591,1916,6507
ΦΘΙΩΤΙΔΑΣ,804,119,222,71,341,2021-02-15T00:00:00,3560,3560,1785,5345
ΦΛΩΡΙΝΑΣ,304,53,80,37,133,2021-02-15T00:00:00,1713,1713,752,2465
ΦΩΚΙΔΑΣ,805,37,50,23,87,2021-02-15T00:00:00,1012,1012,439,1451
ΧΑΛΚΙΔΙΚΗΣ,207,81,100,51,181,2021-02-15T00:00:00,2468,2468,869,3337
ΧΑΝΙΩΝ,1304,164,276,62,440,2021-02-15T00:00:00,6888,6888,2771,9659
ΧΙΟΥ,1105,84,42,31,126,2021-02-15T00:00:00,1837,1837,574,2411
ΑΙΤΩΛΟΑΚΑΡΝΑΝΙΑΣ,701,259,160,-27,419,2021-02-16T00:00:00,4432,4432,1597,6029
ΑΝΑΤΟΛΙΚΗΣ ΑΤΤΙΚΗΣ,901,149,157,-335,306,2021-02-16T00:00:00,9834,9834,2590,12424
ΑΝΔΡΟΥ,1201,0,0,0,0,2021-02-16T00:00:00,263,263,1,264
ΑΡΓΟΛΙΔΑΣ,1001,159,116,27,275,2021-02-16T00:00:00,3142,3142,1407,4549
ΑΡΚΑΔΙΑΣ,1002,135,118,-6,253,2021-02-16T00:00:00,3014,3014,1432,4446
ΑΡΤΑΣ,401,69,126,-13,195,2021-02-16T00:00:00,3128,3128,1499,4627
ΑΧΑΪΑΣ,702,244,238,-133,482,2021-02-16T00:00:00,10090,10090,4911,15001
ΒΟΙΩΤΙΑΣ,801,171,94,87,265,2021-02-16T00:00:00,2936,2936,1205,4141
ΒΟΡΕΙΟΥ ΤΟΜΕΑ ΑΘΗΝΩΝ,902,1048,1000,-3039,2048,2021-02-16T00:00:00,48309,48309,26224,74533
ΓΡΕΒΕΝΩΝ,301,54,50,41,104,2021-02-16T00:00:00,1230,1230,552,1782
ΔΡΑΜΑΣ,101,85,138,22,223,2021-02-16T00:00:00,3268,3268,1439,4707
ΔΥΤΙΚΗΣ ΑΤΤΙΚΗΣ,903,20,52,-117,72,2021-02-16T00:00:00,3090,3090,1487,4577
ΔΥΤΙΚΟΥ ΤΟΜΕΑ ΑΘΗΝΩΝ,904,215,131,-707,346,2021-02-16T00:00:00,17548,17548,6226,23774
ΕΒΡΟΥ,102,188,217,10,405,2021-02-16T00:00:00,5544,5544,2997,8541
ΕΥΒΟΙΑΣ,802,153,237,59,390,2021-02-16T00:00:00,5969,5969,2688,8657
ΕΥΡΥΤΑΝΙΑΣ,803,32,15,10,47,2021-02-16T00:00:00,694,694,369,1063
ΖΑΚΥΝΘΟΥ,601,11,43,-48,54,2021-02-16T00:00:00,1317,1317,732,2049
ΗΛΕΙΑΣ,703,93,152,-43,245,2021-02-16T00:00:00,3875,3875,1807,5682
ΗΜΑΘΙΑΣ,201,197,167,56,364,2021-02-16T00:00:00,4522,4522,1801,6323
ΗΡΑΚΛΕΙΟΥ,1301,319,277,-79,596,2021-02-16T00:00:00,9777,9777,5831,15608
ΘΑΣΟΥ,103,0,0,0,0,2021-02-16T00:00:00,415,415,16,431
ΘΕΣΠΡΩΤΙΑΣ,402,42,112,-18,154,2021-02-16T00:00:00,2244,2244,1045,3289
ΘΕΣΣΑΛΟΝΙΚΗΣ,202,1923,1052,-49,2975,2021-02-16T00:00:00,44541,44541,20617,65158
ΘΗΡΑΣ,1202,0,2,-32,2,2021-02-16T00:00:00,370,370,151,521
ΙΘΑΚΗΣ,602,0,0,0,0,2021-02-16T00:00:00,77,77,0,77
ΙΚΑΡΙΑΣ,1101,0,7,-22,7,2021-02-16T00:00:00,690,690,179,869
ΙΩΑΝΝΙΝΩΝ,403,281,198,-79,479,2021-02-16T00:00:00,8067,8067,4654,12721
ΚΑΒΑΛΑΣ,104,110,188,-4,298,2021-02-16T00:00:00,4391,4391,1911,6302
ΚΑΛΥΜΝΟΥ,1203,9,2,-39,11,2021-02-16T00:00:00,707,707,379,1086
ΚΑΡΔΙΤΣΑΣ,501,267,79,-6,346,2021-02-16T00:00:00,4379,4379,1827,6206
ΚΑΡΠΑΘΟΥ,1204,4,14,0,18,2021-02-16T00:00:00,261,261,120,381
ΚΑΣΤΟΡΙΑΣ,302,65,100,32,165,2021-02-16T00:00:00,2090,2090,900,2990
ΚΕΑΣ-ΚΥΘΝΟΥ,1205,8,0,-5,8,2021-02-16T00:00:00,39,39,0,39
ΚΕΝΤΡΙΚΟΥ ΤΟΜΕΑ ΑΘΗΝΩΝ,905,1108,392,-1715,1500,2021-02-16T00:00:00,63258,63258,28355,91613
ΚΕΡΚΥΡΑΣ,603,97,135,-98,232,2021-02-16T00:00:00,3333,3333,1710,5043
ΚΕΦΑΛΛΗΝΙΑΣ,604,0,0,-90,0,2021-02-16T00:00:00,1647,1647,878,2525
ΚΙΛΚΙΣ,203,54,108,-30,162,2021-02-16T00:00:00,3077,3077,1329,4406
ΚΟΖΑΝΗΣ,303,238,97,17,335,2021-02-16T00:00:00,4785,4785,1692,6477
ΚΟΡΙΝΘΙΑΣ,1003,235,105,30,340,2021-02-16T00:00:00,3345,3345,1025,4370
ΚΩ,1206,40,36,-14,76,2021-02-16T00:00:00,1010,1010,463,1473
ΛΑΚΩΝΙΑΣ,1004,138,145,21,283,2021-02-16T00:00:00,3098,3098,1496,4594
ΛΑΡΙΣΑΣ,502,565,204,70,769,2021-02-16T00:00:00,8475,8475,3660,12135
ΛΑΣΙΘΙΟΥ,1302,70,192,3,262,2021-02-16T00:00:00,4060,4060,2072,6132
ΛΕΣΒΟΥ,1102,39,105,-58,144,2021-02-16T00:00:00,2648,2648,1317,3965
ΛΕΥΚΑΔΑΣ,605,45,56,-8,101,2021-02-16T00:00:00,1503,1503,514,2017
ΛΗΜΝΟΥ,1103,11,31,0,42,2021-02-16T00:00:00,783,783,415,1198
ΜΑΓΝΗΣΙΑΣ,503,178,216,68,394,2021-02-16T00:00:00,4766,4766,1625,6391
ΜΕΣΣΗΝΙΑΣ,1005,166,278,32,444,2021-02-16T00:00:00,5192,5192,2181,7373
ΜΗΛΟΥ,1207,0,0,0,0,2021-02-16T00:00:00,230,230,2,232
ΜΥΚΟΝΟΥ,1208,0,0,0,0,2021-02-16T00:00:00,144,144,0,144
ΝΑΞΟΥ,1209,0,23,-1,23,2021-02-16T00:00:00,445,445,213,658
ΝΗΣΩΝ,906,26,0,-18,26,2021-02-16T00:00:00,1697,1697,150,1847
ΝΟΤΙΟΥ ΤΟΜΕΑ ΑΘΗΝΩΝ,907,333,85,-329,418,2021-02-16T00:00:00,8690,8690,2969,11659
ΞΑΝΘΗΣ,105,45,96,6,141,2021-02-16T00:00:00,2420,2420,1297,3717
ΠΑΡΟΥ,1210,0,0,0,0,2021-02-16T00:00:00,290,290,4,294
ΠΕΙΡΑΙΩΣ,908,124,179,-727,303,2021-02-16T00:00:00,15174,15174,6383,21557
ΠΕΛΛΑΣ,204,204,121,-29,325,2021-02-16T00:00:00,5522,5522,1773,7295
ΠΙΕΡΙΑΣ,205,121,117,22,238,2021-02-16T00:00:00,4011,4011,1270,5281
ΠΡΕΒΕΖΑΣ,404,133,57,25,190,2021-02-16T00:00:00,1338,1338,772,2110
ΡΕΘΥΜΝΟΥ,1303,110,110,-10,220,2021-02-16T00:00:00,2607,2607,1314,3921
ΡΟΔΟΠΗΣ,106,94,101,51,195,2021-02-16T00:00:00,2249,2249,955,3204
ΡΟΔΟΥ,1211,26,119,-82,145,2021-02-16T00:00:00,2612,2612,1151,3763
ΣΑΜΟΥ,1104,40,36,8,76,2021-02-16T00:00:00,956,956,508,1464
ΣΕΡΡΩΝ,206,303,141,71,444,2021-02-16T00:00:00,3815,3815,1582,5397
ΣΠΟΡΑΔΩΝ,504,0,0,-6,0,2021-02-16T00:00:00,245,245,7,252
ΣΥΡΟΥ,1212,0,0,-54,0,2021-02-16T00:00:00,875,875,440,1315
ΤΗΝΟΥ,1213,0,0,0,0,2021-02-16T00:00:00,280,280,1,281
ΤΡΙΚΑΛΩΝ,505,285,128,27,413,2021-02-16T00:00:00,4876,4876,2044,6920
ΦΘΙΩΤΙΔΑΣ,804,139,160,-42,299,2021-02-16T00:00:00,3699,3699,1945,5644
ΦΛΩΡΙΝΑΣ,304,40,41,-52,81,2021-02-16T00:00:00,1753,1753,793,2546
ΦΩΚΙΔΑΣ,805,63,51,27,114,2021-02-16T00:00:00,1075,1075,490,1565
ΧΑΛΚΙΔΙΚΗΣ,207,139,86,44,225,2021-02-16T00:00:00,2607,2607,955,3562
ΧΑΝΙΩΝ,1304,185,193,-62,378,2021-02-16T00:00:00,7073,7073,2964,10037
ΧΙΟΥ,1105,87,44,5,131,2021-02-16T00:00:00,1924,1924,618,2542
ΑΙΤΩΛΟΑΚΑΡΝΑΝΙΑΣ,701,96,0,18,96,2021-01-21T00:00:00,1117,1117,0,1117
ΑΝΑΤΟΛΙΚΗΣ ΑΤΤΙΚΗΣ,901,314,44,42,358,2021-01-21T00:00:00,1404,1404,226,1630
ΑΝΔΡΟΥ,1201,0,0,0,0,2021-01-21T00:00:00,0,0,0,0
ΑΡΓΟΛΙΔΑΣ,1001,198,0,24,198,2021-01-21T00:00:00,879,879,0,879
ΑΡΚΑΔΙΑΣ,1002,145,0,37,145,2021-01-21T00:00:00,866,866,0,866
ΑΡΤΑΣ,401,138,0,6,138,2021-01-21T00:00:00,916,916,0,916
ΑΧΑΪΑΣ,702,424,113,3,537,2021-01-21T00:00:00,3415,3415,301,3716
ΒΟΙΩΤΙΑΣ,801,145,0,-10,145,2021-01-21T00:00:00,770,770,0,770
ΒΟΡΕΙΟΥ ΤΟΜΕΑ ΑΘΗΝΩΝ,902,2208,0,17,2208,2021-01-21T00:00:00,18717,18717,0,18717
ΓΡΕΒΕΝΩΝ,301,56,0,20,56,2021-01-21T00:00:00,371,371,0,371
ΔΡΑΜΑΣ,101,180,0,12,180,2021-01-21T00:00:00,871,871,0,871
ΔΥΤΙΚΗΣ ΑΤΤΙΚΗΣ,903,169,35,29,204,2021-01-21T00:00:00,890,890,230,1120
ΔΥΤΙΚΟΥ ΤΟΜΕΑ ΑΘΗΝΩΝ,904,519,21,56,540,2021-01-21T00:00:00,4038,4038,215,4253
ΕΒΡΟΥ,102,319,0,18,319,2021-01-21T00:00:00,2076,2076,0,2076
ΕΥΒΟΙΑΣ,802,357,0,-77,357,2021-01-21T00:00:00,1717,1717,0,1717
ΕΥΡΥΤΑΝΙΑΣ,803,31,0,2,31,2021-01-21T00:00:00,271,271,0,271
ΖΑΚΥΝΘΟΥ,601,101,0,-1,101,2021-01-21T00:00:00,453,453,0,453
ΗΛΕΙΑΣ,703,198,0,0,198,2021-01-21T00:00:00,1166,1166,0,1166
ΗΜΑΘΙΑΣ,201,199,0,64,199,2021-01-21T00:00:00,1102,1102,0,1102
ΗΡΑΚΛΕΙΟΥ,1301,484,0,-4,484,2021-01-21T00:00:00,4355,4355,0,4355
ΘΑΣΟΥ,103,0,0,0,0,2021-01-21T00:00:00,0,0,0,0
ΘΕΣΠΡΩΤΙΑΣ,402,96,0,0,96,2021-01-21T00:00:00,577,577,0,577
ΘΕΣΣΑΛΟΝΙΚΗΣ,202,1504,78,35,1582,2021-01-21T00:00:00,15075,15075,216,15291
ΘΗΡΑΣ,1202,24,0,6,24,2021-01-21T00:00:00,107,107,0,107
ΙΘΑΚΗΣ,602,0,0,0,0,2021-01-21T00:00:00,0,0,0,0
ΙΚΑΡΙΑΣ,1101,25,0,8,25,2021-01-21T00:00:00,106,106,0,106
ΙΩΑΝΝΙΝΩΝ,403,248,95,14,343,2021-01-21T00:00:00,3357,3357,264,3621
ΚΑΒΑΛΑΣ,104,235,0,87,235,2021-01-21T00:00:00,1142,1142,0,1142
ΚΑΛΥΜΝΟΥ,1203,59,0,26,59,2021-01-21T00:00:00,243,243,0,243
ΚΑΡΔΙΤΣΑΣ,501,209,0,-25,209,2021-01-21T00:00:00,1152,1152,0,1152
ΚΑΡΠΑΘΟΥ,1204,18,0,6,18,2021-01-21T00:00:00,45,45,0,45
ΚΑΣΤΟΡΙΑΣ,302,90,0,31,90,2021-01-21T00:00:00,504,504,0,504
ΚΕΑΣ-ΚΥΘΝΟΥ,1205,0,0,0,0,2021-01-21T00:00:00,0,0,0,0
ΚΕΝΤΡΙΚΟΥ ΤΟΜΕΑ ΑΘΗΝΩΝ,905,1560,117,-60,1677,2021-01-21T00:00:00,23814,23814,525,24339
ΚΕΡΚΥΡΑΣ,603,243,0,12,243,2021-01-21T00:00:00,902,902,0,902
ΚΕΦΑΛΛΗΝΙΑΣ,604,113,0,-24,113,2021-01-21T00:00:00,620,620,0,620
ΚΙΛΚΙΣ,203,180,0,-22,180,2021-01-21T00:00:00,828,828,0,828
ΚΟΖΑΝΗΣ,303,144,0,30,144,2021-01-21T00:00:00,1163,1163,0,1163
ΚΟΡΙΝΘΙΑΣ,1003,109,0,38,109,2021-01-21T00:00:00,560,560,0,560
ΚΩ,1206,48,0,-18,48,2021-01-21T00:00:00,307,307,0,307
ΛΑΚΩΝΙΑΣ,1004,180,0,24,180,2021-01-21T00:00:00,975,975,0,975
ΛΑΡΙΣΑΣ,502,230,94,18,324,2021-01-21T00:00:00,2545,2545,284,2829
ΛΑΣΙΘΙΟΥ,1302,238,0,-15,238,2021-01-21T00:00:00,1284,1284,0,1284
ΛΕΣΒΟΥ,1102,179,0,28,179,2021-01-21T00:00:00,782,782,0,782
ΛΕΥΚΑΔΑΣ,605,67,0,20,67,2021-01-21T00:00:00,285,285,0,285
ΛΗΜΝΟΥ,1103,0,0,-42,0,2021-01-21T00:00:00,269,269,0,269
ΜΑΓΝΗΣΙΑΣ,503,126,0,48,126,2021-01-21T00:00:00,886,886,0,886
ΜΕΣΣΗΝΙΑΣ,1005,237,0,62,237,2021-01-21T00:00:00,1182,1182,0,1182
ΜΗΛΟΥ,1207,0,0,0,0,2021-01-21T00:00:00,0,0,0,0
ΜΥΚΟΝΟΥ,1208,0,0,0,0,2021-01-21T00:00:00,0,0,0,0
ΝΑΞΟΥ,1209,30,0,0,30,2021-01-21T00:00:00,132,132,0,132
ΝΗΣΩΝ,906,6,0,-12,6,2021-01-21T00:00:00,88,88,0,88
ΝΟΤΙΟΥ ΤΟΜΕΑ ΑΘΗΝΩΝ,907,257,0,-15,257,2021-01-21T00:00:00,1971,1971,0,1971
ΞΑΝΘΗΣ,105,121,0,4,121,2021-01-21T00:00:00,908,908,0,908
ΠΑΡΟΥ,1210,0,0,0,0,2021-01-21T00:00:00,0,0,0,0
ΠΕΙΡΑΙΩΣ,908,504,0,-132,504,2021-01-21T00:00:00,4332,4332,0,4332
ΠΕΛΛΑΣ,204,246,0,50,246,2021-01-21T00:00:00,1126,1126,0,1126
ΠΙΕΡΙΑΣ,205,102,0,-6,102,2021-01-21T00:00:00,732,732,0,732
ΠΡΕΒΕΖΑΣ,404,66,0,18,66,2021-01-21T00:00:00,525,525,0,525
ΡΕΘΥΜΝΟΥ,1303,142,0,-8,142,2021-01-21T00:00:00,817,817,0,817
ΡΟΔΟΠΗΣ,106,102,0,12,102,2021-01-21T00:00:00,585,585,0,585
ΡΟΔΟΥ,1211,96,0,0,96,2021-01-21T00:00:00,717,717,0,717
ΣΑΜΟΥ,1104,60,0,12,60,2021-01-21T00:00:00,348,348,0,348
ΣΕΡΡΩΝ,206,139,0,13,139,2021-01-21T00:00:00,1027,1027,0,1027
ΣΠΟΡΑΔΩΝ,504,0,0,0,0,2021-01-21T00:00:00,0,0,0,0
ΣΥΡΟΥ,1212,48,0,0,48,2021-01-21T00:00:00,295,295,0,295
ΤΗΝΟΥ,1213,0,0,0,0,2021-01-21T00:00:00,0,0,0,0
ΤΡΙΚΑΛΩΝ,505,240,0,61,240,2021-01-21T00:00:00,1246,1246,0,1246
ΦΘΙΩΤΙΔΑΣ,804,210,0,71,210,2021-01-21T00:00:00,1183,1183,0,1183
ΦΛΩΡΙΝΑΣ,304,108,0,42,108,2021-01-21T00:00:00,488,488,0,488
ΦΩΚΙΔΑΣ,805,54,0,6,54,2021-01-21T00:00:00,276,276,0,276
ΧΑΛΚΙΔΙΚΗΣ,207,121,0,31,121,2021-01-21T00:00:00,521,521,0,521
ΧΑΝΙΩΝ,1304,351,0,6,351,2021-01-21T00:00:00,1833,1833,0,1833
ΧΙΟΥ,1105,54,0,24,54,2021-01-21T00:00:00,413,413,0,413
ΑΙΤΩΛΟΑΚΑΡΝΑΝΙΑΣ,701,125,0,29,125,2021-01-22T00:00:00,1242,1242,0,1242
ΑΝΑΤΟΛΙΚΗΣ ΑΤΤΙΚΗΣ,901,405,45,92,450,2021-01-22T00:00:00,1809,1809,271,2080
ΑΝΔΡΟΥ,1201,0,0,0,0,2021-01-22T00:00:00,0,0,0,0
ΑΡΓΟΛΙΔΑΣ,1001,146,0,-52,146,2021-01-22T00:00:00,1025,1025,0,1025
ΑΡΚΑΔΙΑΣ,1002,144,0,-1,144,2021-01-22T00:00:00,1010,1010,0,1010
ΑΡΤΑΣ,401,168,0,30,168,2021-01-22T00:00:00,1084,1084,0,1084
ΑΧΑΪΑΣ,702,504,7,-26,511,2021-01-22T00:00:00,3919,3919,308,4227
ΒΟΙΩΤΙΑΣ,801,149,0,4,149,2021-01-22T00:00:00,919,919,0,919
ΒΟΡΕΙΟΥ ΤΟΜΕΑ ΑΘΗΝΩΝ,902,2501,0,293,2501,2021-01-22T00:00:00,21218,21218,0,21218
ΓΡΕΒΕΝΩΝ,301,54,0,-2,54,2021-01-22T00:00:00,425,425,0,425
ΔΡΑΜΑΣ,101,168,0,-12,168,2021-01-22T00:00:00,1039,1039,0,1039
ΔΥΤΙΚΗΣ ΑΤΤΙΚΗΣ,903,269,1,66,270,2021-01-22T00:00:00,1159,1159,231,1390
ΔΥΤΙΚΟΥ ΤΟΜΕΑ ΑΘΗΝΩΝ,904,703,30,193,733,2021-01-22T00:00:00,4741,4741,245,4986
ΕΒΡΟΥ,102,289,0,-30,289,2021-01-22T00:00:00,2365,2365,0,2365
ΕΥΒΟΙΑΣ,802,278,0,-79,278,2021-01-22T00:00:00,1995,1995,0,1995
ΕΥΡΥΤΑΝΙΑΣ,803,36,0,5,36,2021-01-22T00:00:00,307,307,0,307
ΖΑΚΥΝΘΟΥ,601,78,0,-23,78,2021-01-22T00:00:00,531,531,0,531
ΗΛΕΙΑΣ,703,183,0,-15,183,2021-01-22T00:00:00,1349,1349,0,1349
ΗΜΑΘΙΑΣ,201,220,0,21,220,2021-01-22T00:00:00,1322,1322,0,1322
ΗΡΑΚΛΕΙΟΥ,1301,480,0,-4,480,2021-01-22T00:00:00,4835,4835,0,4835
ΘΑΣΟΥ,103,0,0,0,0,2021-01-22T00:00:00,0,0,0,0
ΘΕΣΠΡΩΤΙΑΣ,402,134,0,38,134,2021-01-22T00:00:00,711,711,0,711
ΘΕΣΣΑΛΟΝΙΚΗΣ,202,1941,40,399,1981,2021-01-22T00:00:00,17016,17016,256,17272
ΘΗΡΑΣ,1202,18,0,-6,18,2021-01-22T00:00:00,125,125,0,125
ΙΘΑΚΗΣ,602,0,0,0,0,2021-01-22T00:00:00,0,0,0,0
ΙΚΑΡΙΑΣ,1101,23,0,-2,23,2021-01-22T00:00:00,129,129,0,129
ΙΩΑΝΝΙΝΩΝ,403,392,10,59,402,2021-01-22T00:00:00,3749,3749,274,4023
ΚΑΒΑΛΑΣ,104,240,0,5,240,2021-01-22T00:00:00,1382,1382,0,1382
ΚΑΛΥΜΝΟΥ,1203,49,0,-10,49,2021-01-22T00:00:00,292,292,0,292
ΚΑΡΔΙΤΣΑΣ,501,275,0,66,275,2021-01-22T00:00:00,1427,1427,0,1427
ΚΑΡΠΑΘΟΥ,1204,30,0,12,30,2021-01-22T00:00:00,75,75,0,75
ΚΑΣΤΟΡΙΑΣ,302,113,0,23,113,2021-01-22T00:00:00,617,617,0,617
ΚΕΑΣ-ΚΥΘΝΟΥ,1205,0,0,0,0,2021-01-22T00:00:00,0,0,0,0
ΚΕΝΤΡΙΚΟΥ ΤΟΜΕΑ ΑΘΗΝΩΝ,905,1834,92,249,1926,2021-01-22T00:00:00,25648,25648,617,26265
ΚΕΡΚΥΡΑΣ,603,235,0,-8,235,2021-01-22T00:00:00,1137,1137,0,1137
ΚΕΦΑΛΛΗΝΙΑΣ,604,96,0,-17,96,2021-01-22T00:00:00,716,716,0,716
ΚΙΛΚΙΣ,203,174,0,-6,174,2021-01-22T00:00:00,1002,1002,0,1002
ΚΟΖΑΝΗΣ,303,193,0,49,193,2021-01-22T00:00:00,1356,1356,0,1356
ΚΟΡΙΝΘΙΑΣ,1003,138,0,29,138,2021-01-22T00:00:00,698,698,0,698
ΚΩ,1206,48,0,0,48,2021-01-22T00:00:00,355,355,0,355
ΛΑΚΩΝΙΑΣ,1004,143,0,-37,143,2021-01-22T00:00:00,1118,1118,0,1118
ΛΑΡΙΣΑΣ,502,312,93,81,405,2021-01-22T00:00:00,2857,2857,377,3234
ΛΑΣΙΘΙΟΥ,1302,224,0,-14,224,2021-01-22T00:00:00,1508,1508,0,1508
ΛΕΣΒΟΥ,1102,149,0,-30,149,2021-01-22T00:00:00,931,931,0,931
ΛΕΥΚΑΔΑΣ,605,66,0,-1,66,2021-01-22T00:00:00,351,351,0,351
ΛΗΜΝΟΥ,1103,54,0,54,54,2021-01-22T00:00:00,323,323,0,323
ΜΑΓΝΗΣΙΑΣ,503,148,0,22,148,2021-01-22T00:00:00,1034,1034,0,1034
ΜΕΣΣΗΝΙΑΣ,1005,220,0,-17,220,2021-01-22T00:00:00,1402,1402,0,1402
ΜΗΛΟΥ,1207,0,0,0,0,2021-01-22T00:00:00,0,0,0,0
ΜΥΚΟΝΟΥ,1208,0,0,0,0,2021-01-22T00:00:00,0,0,0,0
ΝΑΞΟΥ,1209,30,0,0,30,2021-01-22T00:00:00,162,162,0,162
ΝΗΣΩΝ,906,18,0,12,18,2021-01-22T00:00:00,106,106,0,106
ΝΟΤΙΟΥ ΤΟΜΕΑ ΑΘΗΝΩΝ,907,359,0,102,359,2021-01-22T00:00:00,2330,2330,0,2330
ΞΑΝΘΗΣ,105,120,0,-1,120,2021-01-22T00:00:00,1028,1028,0,1028
ΠΑΡΟΥ,1210,0,0,0,0,2021-01-22T00:00:00,0,0,0,0
ΠΕΙΡΑΙΩΣ,908,711,0,207,711,2021-01-22T00:00:00,5043,5043,0,5043
ΠΕΛΛΑΣ,204,205,0,-41,205,2021-01-22T00:00:00,1331,1331,0,1331
ΠΙΕΡΙΑΣ,205,168,0,66,168,2021-01-22T00:00:00,900,900,0,900
ΠΡΕΒΕΖΑΣ,404,66,0,0,66,2021-01-22T00:00:00,591,591,0,591
ΡΕΘΥΜΝΟΥ,1303,123,0,-19,123,2021-01-22T00:00:00,940,940,0,940
ΡΟΔΟΠΗΣ,106,96,0,-6,96,2021-01-22T00:00:00,681,681,0,681
ΡΟΔΟΥ,1211,96,0,0,96,2021-01-22T00:00:00,813,813,0,813
ΣΑΜΟΥ,1104,54,0,-6,54,2021-01-22T00:00:00,402,402,0,402
ΣΕΡΡΩΝ,206,150,0,11,150,2021-01-22T00:00:00,1177,1177,0,1177
ΣΠΟΡΑΔΩΝ,504,0,0,0,0,2021-01-22T00:00:00,0,0,0,0
ΣΥΡΟΥ,1212,57,0,9,57,2021-01-22T00:00:00,352,352,0,352
ΤΗΝΟΥ,1213,0,0,0,0,2021-01-22T00:00:00,0,0,0,0
ΤΡΙΚΑΛΩΝ,505,270,0,30,270,2021-01-22T00:00:00,1516,1516,0,1516
ΦΘΙΩΤΙΔΑΣ,804,233,0,23,233,2021-01-22T00:00:00,1416,1416,0,1416
ΦΛΩΡΙΝΑΣ,304,102,0,-6,102,2021-01-22T00:00:00,590,590,0,590
ΦΩΚΙΔΑΣ,805,60,0,6,60,2021-01-22T00:00:00,336,336,0,336
ΧΑΛΚΙΔΙΚΗΣ,207,135,0,14,135,2021-01-22T00:00:00,656,656,0,656
ΧΑΝΙΩΝ,1304,351,0,0,351,2021-01-22T00:00:00,2184,2184,0,2184
ΧΙΟΥ,1105,78,0,24,78,2021-01-22T00:00:00,491,491,0,491
ΑΙΤΩΛΟΑΚΑΡΝΑΝΙΑΣ,701,144,0,19,144,2021-01-23T00:00:00,1386,1386,0,1386
ΑΝΑΤΟΛΙΚΗΣ ΑΤΤΙΚΗΣ,901,411,49,10,460,2021-01-23T00:00:00,2220,2220,320,2540
ΑΝΔΡΟΥ,1201,0,0,0,0,2021-01-23T00:00:00,0,0,0,0
ΑΡΓΟΛΙΔΑΣ,1001,127,0,-19,127,2021-01-23T00:00:00,1152,1152,0,1152
ΑΡΚΑΔΙΑΣ,1002,174,0,30,174,2021-01-23T00:00:00,1184,1184,0,1184
ΑΡΤΑΣ,401,186,0,18,186,2021-01-23T00:00:00,1270,1270,0,1270
ΑΧΑΪΑΣ,702,448,91,28,539,2021-01-23T00:00:00,4367,4367,399,4766
ΒΟΙΩΤΙΑΣ,801,132,0,-17,132,2021-01-23T00:00:00,1051,1051,0,1051
ΒΟΡΕΙΟΥ ΤΟΜΕΑ ΑΘΗΝΩΝ,902,1593,0,-908,1593,2021-01-23T00:00:00,22811,22811,0,22811
ΓΡΕΒΕΝΩΝ,301,42,0,-12,42,2021-01-23T00:00:00,467,467,0,467
ΔΡΑΜΑΣ,101,144,0,-24,144,2021-01-23T00:00:00,1183,1183,0,1183
ΔΥΤΙΚΗΣ ΑΤΤΙΚΗΣ,903,210,0,-60,210,2021-01-23T00:00:00,1369,1369,231,1600
ΔΥΤΙΚΟΥ ΤΟΜΕΑ ΑΘΗΝΩΝ,904,794,57,118,851,2021-01-23T00:00:00,5535,5535,302,5837
ΕΒΡΟΥ,102,240,0,-49,240,2021-01-23T00:00:00,2605,2605,0,2605
ΕΥΒΟΙΑΣ,802,238,0,-40,238,2021-01-23T00:00:00,2233,2233,0,2233
ΕΥΡΥΤΑΝΙΑΣ,803,18,0,-18,18,2021-01-23T00:00:00,325,325,0,325
ΖΑΚΥΝΘΟΥ,601,90,0,12,90,2021-01-23T00:00:00,621,621,0,621
ΗΛΕΙΑΣ,703,157,0,-26,157,2021-01-23T00:00:00,1506,1506,0,1506
ΗΜΑΘΙΑΣ,201,186,0,-34,186,2021-01-23T00:00:00,1508,1508,0,1508
ΗΡΑΚΛΕΙΟΥ,1301,454,0,-26,454,2021-01-23T00:00:00,5289,5289,0,5289
ΘΑΣΟΥ,103,0,0,0,0,2021-01-23T00:00:00,0,0,0,0
ΘΕΣΠΡΩΤΙΑΣ,402,147,0,13,147,2021-01-23T00:00:00,858,858,0,858
ΘΕΣΣΑΛΟΝΙΚΗΣ,202,1712,78,-191,1790,2021-01-23T00:00:00,18728,18728,334,19062
ΘΗΡΑΣ,1202,6,0,-12,6,2021-01-23T00:00:00,131,131,0,131
ΙΘΑΚΗΣ,602,0,0,0,0,2021-01-23T00:00:00,0,0,0,0
ΙΚΑΡΙΑΣ,1101,18,0,-5,18,2021-01-23T00:00:00,147,147,0,147
ΙΩΑΝΝΙΝΩΝ,403,353,68,19,421,2021-01-23T00:00:00,4102,4102,342,4444
ΚΑΒΑΛΑΣ,104,192,0,-48,192,2021-01-23T00:00:00,1574,1574,0,1574
ΚΑΛΥΜΝΟΥ,1203,35,0,-14,35,2021-01-23T00:00:00,327,327,0,327
ΚΑΡΔΙΤΣΑΣ,501,199,0,-76,199,2021-01-23T00:00:00,1626,1626,0,1626
ΚΑΡΠΑΘΟΥ,1204,18,0,-12,18,2021-01-23T00:00:00,93,93,0,93
ΚΑΣΤΟΡΙΑΣ,302,91,0,-22,91,2021-01-23T00:00:00,708,708,0,708
ΚΕΑΣ-ΚΥΘΝΟΥ,1205,0,0,0,0,2021-01-23T00:00:00,0,0,0,0
ΚΕΝΤΡΙΚΟΥ ΤΟΜΕΑ ΑΘΗΝΩΝ,905,1695,129,-102,1824,2021-01-23T00:00:00,27343,27343,746,28089
ΚΕΡΚΥΡΑΣ,603,256,0,21,256,2021-01-23T00:00:00,1393,1393,0,1393
ΚΕΦΑΛΛΗΝΙΑΣ,604,57,0,-39,57,2021-01-23T00:00:00,773,773,0,773
ΚΙΛΚΙΣ,203,102,0,-72,102,2021-01-23T00:00:00,1104,1104,0,1104
ΚΟΖΑΝΗΣ,303,192,0,-1,192,2021-01-23T00:00:00,1548,1548,0,1548
ΚΟΡΙΝΘΙΑΣ,1003,132,0,-6,132,2021-01-23T00:00:00,830,830,0,830
ΚΩ,1206,30,0,-18,30,2021-01-23T00:00:00,385,385,0,385
ΛΑΚΩΝΙΑΣ,1004,143,0,0,143,2021-01-23T00:00:00,1261,1261,0,1261
ΛΑΡΙΣΑΣ,502,407,83,85,490,2021-01-23T00:00:00,3264,3264,460,3724
ΛΑΣΙΘΙΟΥ,1302,198,0,-26,198,2021-01-23T00:00:00,1706,1706,0,1706
ΛΕΣΒΟΥ,1102,144,0,-5,144,2021-01-23T00:00:00,1075,1075,0,1075
ΛΕΥΚΑΔΑΣ,605,72,0,6,72,2021-01-23T00:00:00,423,423,0,423
ΛΗΜΝΟΥ,1103,42,0,-12,42,2021-01-23T00:00:00,365,365,0,365
ΜΑΓΝΗΣΙΑΣ,503,174,0,26,174,2021-01-23T00:00:00,1208,1208,0,1208
ΜΕΣΣΗΝΙΑΣ,1005,231,0,11,231,2021-01-23T00:00:00,1633,1633,0,1633
ΜΗΛΟΥ,1207,0,0,0,0,2021-01-23T00:00:00,0,0,0,0
ΜΥΚΟΝΟΥ,1208,0,0,0,0,2021-01-23T00:00:00,0,0,0,0
ΝΑΞΟΥ,1209,18,0,-12,18,2021-01-23T00:00:00,180,180,0,180
ΝΗΣΩΝ,906,12,0,-6,12,2021-01-23T00:00:00,118,118,0,118
ΝΟΤΙΟΥ ΤΟΜΕΑ ΑΘΗΝΩΝ,907,278,0,-81,278,2021-01-23T00:00:00,2608,2608,0,2608
ΞΑΝΘΗΣ,105,102,0,-18,102,2021-01-23T00:00:00,1130,1130,0,1130
ΠΑΡΟΥ,1210,0,0,0,0,2021-01-23T00:00:00,0,0,0,0
ΠΕΙΡΑΙΩΣ,908,722,0,11,722,2021-01-23T00:00:00,5765,5765,0,5765
ΠΕΛΛΑΣ,204,193,0,-12,193,2021-01-23T00:00:00,1524,1524,0,1524
ΠΙΕΡΙΑΣ,205,186,0,18,186,2021-01-23T00:00:00,1086,1086,0,1086
ΠΡΕΒΕΖΑΣ,404,72,0,6,72,2021-01-23T00:00:00,663,663,0,663
ΡΕΘΥΜΝΟΥ,1303,126,0,3,126,2021-01-23T00:00:00,1066,1066,0,1066
ΡΟΔΟΠΗΣ,106,96,0,0,96,2021-01-23T00:00:00,777,777,0,777
ΡΟΔΟΥ,1211,96,0,0,96,2021-01-23T00:00:00,909,909,0,909
ΣΑΜΟΥ,1104,36,0,-18,36,2021-01-23T00:00:00,438,438,0,438
ΣΕΡΡΩΝ,206,144,0,-6,144,2021-01-23T00:00:00,1321,1321,0,1321
ΣΠΟΡΑΔΩΝ,504,0,0,0,0,2021-01-23T00:00:00,0,0,0,0
ΣΥΡΟΥ,1212,42,0,-15,42,2021-01-23T00:00:00,394,394,0,394
ΤΗΝΟΥ,1213,0,0,0,0,2021-01-23T00:00:00,0,0,0,0
ΤΡΙΚΑΛΩΝ,505,249,1,-20,250,2021-01-23T00:00:00,1765,1765,1,1766
ΦΘΙΩΤΙΔΑΣ,804,205,0,-28,205,2021-01-23T00:00:00,1621,1621,0,1621
ΦΛΩΡΙΝΑΣ,304,90,0,-12,90,2021-01-23T00:00:00,680,680,0,680
ΦΩΚΙΔΑΣ,805,60,0,0,60,2021-01-23T00:00:00,396,396,0,396
ΧΑΛΚΙΔΙΚΗΣ,207,117,0,-18,117,2021-01-23T00:00:00,773,773,0,773
ΧΑΝΙΩΝ,1304,342,0,-9,342,2021-01-23T00:00:00,2526,2526,0,2526
ΧΙΟΥ,1105,48,0,-30,48,2021-01-23T00:00:00,539,539,0,539
ΑΙΤΩΛΟΑΚΑΡΝΑΝΙΑΣ,701,78,47,-19,125,2021-01-25T00:00:00,1464,1464,47,1511
ΑΝΑΤΟΛΙΚΗΣ ΑΤΤΙΚΗΣ,901,356,96,-8,452,2021-01-25T00:00:00,2576,2576,416,2992
ΑΝΔΡΟΥ,1201,0,0,0,0,2021-01-25T00:00:00,0,0,0,0
ΑΡΓΟΛΙΔΑΣ,1001,143,0,16,143,2021-01-25T00:00:00,1295,1295,0,1295
ΑΡΚΑΔΙΑΣ,1002,180,0,6,180,2021-01-25T00:00:00,1364,1364,0,1364
ΑΡΤΑΣ,401,186,48,48,234,2021-01-25T00:00:00,1456,1456,48,1504
ΑΧΑΪΑΣ,702,366,269,96,635,2021-01-25T00:00:00,4733,4733,668,5401
ΒΟΙΩΤΙΑΣ,801,162,0,30,162,2021-01-25T00:00:00,1213,1213,0,1213
ΒΟΡΕΙΟΥ ΤΟΜΕΑ ΑΘΗΝΩΝ,902,2128,522,1057,2650,2021-01-25T00:00:00,24939,24939,522,25461
ΓΡΕΒΕΝΩΝ,301,48,0,6,48,2021-01-25T00:00:00,515,515,0,515
ΔΡΑΜΑΣ,101,144,0,0,144,2021-01-25T00:00:00,1327,1327,0,1327
ΔΥΤΙΚΗΣ ΑΤΤΙΚΗΣ,903,124,62,-24,186,2021-01-25T00:00:00,1493,1493,293,1786
ΔΥΤΙΚΟΥ ΤΟΜΕΑ ΑΘΗΝΩΝ,904,723,99,-29,822,2021-01-25T00:00:00,6258,6258,401,6659
ΕΒΡΟΥ,102,240,0,0,240,2021-01-25T00:00:00,2845,2845,0,2845
ΕΥΒΟΙΑΣ,802,319,0,81,319,2021-01-25T00:00:00,2552,2552,0,2552
ΕΥΡΥΤΑΝΙΑΣ,803,36,0,18,36,2021-01-25T00:00:00,361,361,0,361
ΖΑΚΥΝΘΟΥ,601,96,0,6,96,2021-01-25T00:00:00,717,717,0,717
ΗΛΕΙΑΣ,703,203,0,46,203,2021-01-25T00:00:00,1709,1709,0,1709
ΗΜΑΘΙΑΣ,201,139,47,0,186,2021-01-25T00:00:00,1647,1647,47,1694
ΗΡΑΚΛΕΙΟΥ,1301,371,132,49,503,2021-01-25T00:00:00,5660,5660,132,5792
ΘΑΣΟΥ,103,0,0,0,0,2021-01-25T00:00:00,0,0,0,0
ΘΕΣΠΡΩΤΙΑΣ,402,114,0,-33,114,2021-01-25T00:00:00,972,972,0,972
ΘΕΣΣΑΛΟΝΙΚΗΣ,202,1133,802,145,1935,2021-01-25T00:00:00,19861,19861,1136,20997
ΘΗΡΑΣ,1202,18,0,12,18,2021-01-25T00:00:00,149,149,0,149
ΙΘΑΚΗΣ,602,0,0,0,0,2021-01-25T00:00:00,0,0,0,0
ΙΚΑΡΙΑΣ,1101,30,0,12,30,2021-01-25T00:00:00,177,177,0,177
ΙΩΑΝΝΙΝΩΝ,403,357,144,80,501,2021-01-25T00:00:00,4459,4459,486,4945
ΚΑΒΑΛΑΣ,104,192,0,0,192,2021-01-25T00:00:00,1766,1766,0,1766
ΚΑΛΥΜΝΟΥ,1203,41,0,6,41,2021-01-25T00:00:00,368,368,0,368
ΚΑΡΔΙΤΣΑΣ,501,184,92,77,276,2021-01-25T00:00:00,1810,1810,92,1902
ΚΑΡΠΑΘΟΥ,1204,24,0,6,24,2021-01-25T00:00:00,117,117,0,117
ΚΑΣΤΟΡΙΑΣ,302,95,0,4,95,2021-01-25T00:00:00,803,803,0,803
ΚΕΑΣ-ΚΥΘΝΟΥ,1205,0,0,0,0,2021-01-25T00:00:00,0,0,0,0
ΚΕΝΤΡΙΚΟΥ ΤΟΜΕΑ ΑΘΗΝΩΝ,905,1235,1733,1144,2968,2021-01-25T00:00:00,28578,28578,2479,31057
ΚΕΡΚΥΡΑΣ,603,229,0,-27,229,2021-01-25T00:00:00,1622,1622,0,1622
ΚΕΦΑΛΛΗΝΙΑΣ,604,95,0,38,95,2021-01-25T00:00:00,868,868,0,868
ΚΙΛΚΙΣ,203,150,0,48,150,2021-01-25T00:00:00,1254,1254,0,1254
ΚΟΖΑΝΗΣ,303,75,122,5,197,2021-01-25T00:00:00,1623,1623,122,1745
ΚΟΡΙΝΘΙΑΣ,1003,125,48,41,173,2021-01-25T00:00:00,955,955,48,1003
ΚΩ,1206,53,0,23,53,2021-01-25T00:00:00,438,438,0,438
ΛΑΚΩΝΙΑΣ,1004,185,0,42,185,2021-01-25T00:00:00,1446,1446,0,1446
ΛΑΡΙΣΑΣ,502,342,189,41,531,2021-01-25T00:00:00,3606,3606,649,4255
ΛΑΣΙΘΙΟΥ,1302,210,0,12,210,2021-01-25T00:00:00,1916,1916,0,1916
ΛΕΣΒΟΥ,1102,156,0,12,156,2021-01-25T00:00:00,1231,1231,0,1231
ΛΕΥΚΑΔΑΣ,605,72,0,0,72,2021-01-25T00:00:00,495,495,0,495
ΛΗΜΝΟΥ,1103,42,0,0,42,2021-01-25T00:00:00,407,407,0,407
ΜΑΓΝΗΣΙΑΣ,503,217,0,43,217,2021-01-25T00:00:00,1425,1425,0,1425
ΜΕΣΣΗΝΙΑΣ,1005,363,0,132,363,2021-01-25T00:00:00,1996,1996,0,1996
ΜΗΛΟΥ,1207,0,0,0,0,2021-01-25T00:00:00,0,0,0,0
ΜΥΚΟΝΟΥ,1208,0,0,0,0,2021-01-25T00:00:00,0,0,0,0
ΝΑΞΟΥ,1209,24,0,6,24,2021-01-25T00:00:00,204,204,0,204
ΝΗΣΩΝ,906,12,0,0,12,2021-01-25T00:00:00,130,130,0,130
ΝΟΤΙΟΥ ΤΟΜΕΑ ΑΘΗΝΩΝ,907,289,0,11,289,2021-01-25T00:00:00,2897,2897,0,2897
ΞΑΝΘΗΣ,105,96,0,-6,96,2021-01-25T00:00:00,1226,1226,0,1226
ΠΑΡΟΥ,1210,0,0,0,0,2021-01-25T00:00:00,0,0,0,0
ΠΕΙΡΑΙΩΣ,908,644,93,15,737,2021-01-25T00:00:00,6409,6409,93,6502
ΠΕΛΛΑΣ,204,146,94,47,240,2021-01-25T00:00:00,1670,1670,94,1764
ΠΙΕΡΙΑΣ,205,86,94,-6,180,2021-01-25T00:00:00,1172,1172,94,1266
ΠΡΕΒΕΖΑΣ,404,72,0,0,72,2021-01-25T00:00:00,735,735,0,735
ΡΕΘΥΜΝΟΥ,1303,144,0,18,144,2021-01-25T00:00:00,1210,1210,0,1210
ΡΟΔΟΠΗΣ,106,96,0,0,96,2021-01-25T00:00:00,873,873,0,873
ΡΟΔΟΥ,1211,234,0,138,234,2021-01-25T00:00:00,1143,1143,0,1143
ΣΑΜΟΥ,1104,47,1,12,48,2021-01-25T00:00:00,485,485,1,486
ΣΕΡΡΩΝ,206,144,0,0,144,2021-01-25T00:00:00,1465,1465,0,1465
ΣΠΟΡΑΔΩΝ,504,0,0,0,0,2021-01-25T00:00:00,0,0,0,0
ΣΥΡΟΥ,1212,60,0,18,60,2021-01-25T00:00:00,454,454,0,454
ΤΗΝΟΥ,1213,0,0,0,0,2021-01-25T00:00:00,0,0,0,0
ΤΡΙΚΑΛΩΝ,505,227,96,73,323,2021-01-25T00:00:00,1992,1992,97,2089
ΦΘΙΩΤΙΔΑΣ,804,222,0,17,222,2021-01-25T00:00:00,1843,1843,0,1843
ΦΛΩΡΙΝΑΣ,304,96,0,6,96,2021-01-25T00:00:00,776,776,0,776
ΦΩΚΙΔΑΣ,805,54,0,-6,54,2021-01-25T00:00:00,450,450,0,450
ΧΑΛΚΙΔΙΚΗΣ,207,122,2,7,124,2021-01-25T00:00:00,895,895,2,897
ΧΑΝΙΩΝ,1304,282,94,34,376,2021-01-25T00:00:00,2808,2808,94,2902
ΧΙΟΥ,1105,48,0,0,48,2021-01-25T00:00:00,587,587,0,587
ΑΙΤΩΛΟΑΚΑΡΝΑΝΙΑΣ,701,171,47,93,218,2021-01-26T00:00:00,1635,1635,94,1729
ΑΝΑΤΟΛΙΚΗΣ ΑΤΤΙΚΗΣ,901,415,53,16,468,2021-01-26T00:00:00,2991,2991,469,3460
ΑΝΔΡΟΥ,1201,0,0,0,0,2021-01-26T00:00:00,0,0,0,0
ΑΡΓΟΛΙΔΑΣ,1001,126,0,-17,126,2021-01-26T00:00:00,1421,1421,0,1421
ΑΡΚΑΔΙΑΣ,1002,124,0,-56,124,2021-01-26T00:00:00,1488,1488,0,1488
ΑΡΤΑΣ,401,96,48,-90,144,2021-01-26T00:00:00,1552,1552,96,1648
ΑΧΑΪΑΣ,702,262,242,-131,504,2021-01-26T00:00:00,4995,4995,910,5905
ΒΟΙΩΤΙΑΣ,801,120,0,-42,120,2021-01-26T00:00:00,1333,1333,0,1333
ΒΟΡΕΙΟΥ ΤΟΜΕΑ ΑΘΗΝΩΝ,902,1692,612,-346,2304,2021-01-26T00:00:00,26631,26631,1134,27765
ΓΡΕΒΕΝΩΝ,301,54,0,6,54,2021-01-26T00:00:00,569,569,0,569
ΔΡΑΜΑΣ,101,144,0,0,144,2021-01-26T00:00:00,1471,1471,0,1471
ΔΥΤΙΚΗΣ ΑΤΤΙΚΗΣ,903,93,39,-54,132,2021-01-26T00:00:00,1586,1586,332,1918
ΔΥΤΙΚΟΥ ΤΟΜΕΑ ΑΘΗΝΩΝ,904,680,94,-48,774,2021-01-26T00:00:00,6938,6938,495,7433
ΕΒΡΟΥ,102,234,0,-6,234,2021-01-26T00:00:00,3079,3079,0,3079
ΕΥΒΟΙΑΣ,802,275,0,-44,275,2021-01-26T00:00:00,2827,2827,0,2827
ΕΥΡΥΤΑΝΙΑΣ,803,18,0,-18,18,2021-01-26T00:00:00,379,379,0,379
ΖΑΚΥΝΘΟΥ,601,47,0,-49,47,2021-01-26T00:00:00,764,764,0,764
ΗΛΕΙΑΣ,703,154,0,-49,154,2021-01-26T00:00:00,1863,1863,0,1863
ΗΜΑΘΙΑΣ,201,165,47,26,212,2021-01-26T00:00:00,1812,1812,94,1906
ΗΡΑΚΛΕΙΟΥ,1301,288,122,-93,410,2021-01-26T00:00:00,5948,5948,254,6202
ΘΑΣΟΥ,103,0,0,0,0,2021-01-26T00:00:00,0,0,0,0
ΘΕΣΠΡΩΤΙΑΣ,402,90,0,-24,90,2021-01-26T00:00:00,1062,1062,0,1062
ΘΕΣΣΑΛΟΝΙΚΗΣ,202,1117,896,78,2013,2021-01-26T00:00:00,20978,20978,2032,23010
ΘΗΡΑΣ,1202,18,0,0,18,2021-01-26T00:00:00,167,167,0,167
ΙΘΑΚΗΣ,602,0,0,0,0,2021-01-26T00:00:00,0,0,0,0
ΙΚΑΡΙΑΣ,1101,12,0,-18,12,2021-01-26T00:00:00,189,189,0,189
ΙΩΑΝΝΙΝΩΝ,403,148,236,-117,384,2021-01-26T00:00:00,4607,4607,722,5329
ΚΑΒΑΛΑΣ,104,198,0,6,198,2021-01-26T00:00:00,1964,1964,0,1964
ΚΑΛΥΜΝΟΥ,1203,11,0,-30,11,2021-01-26T00:00:00,379,379,0,379
ΚΑΡΔΙΤΣΑΣ,501,73,95,-108,168,2021-01-26T00:00:00,1883,1883,187,2070
ΚΑΡΠΑΘΟΥ,1204,30,0,6,30,2021-01-26T00:00:00,147,147,0,147
ΚΑΣΤΟΡΙΑΣ,302,106,0,11,106,2021-01-26T00:00:00,909,909,0,909
ΚΕΑΣ-ΚΥΘΝΟΥ,1205,0,0,0,0,2021-01-26T00:00:00,0,0,0,0
ΚΕΝΤΡΙΚΟΥ ΤΟΜΕΑ ΑΘΗΝΩΝ,905,1314,1725,71,3039,2021-01-26T00:00:00,29892,29892,4204,34096
ΚΕΡΚΥΡΑΣ,603,144,0,-85,144,2021-01-26T00:00:00,1766,1766,0,1766
ΚΕΦΑΛΛΗΝΙΑΣ,604,54,0,-41,54,2021-01-26T00:00:00,922,922,0,922
ΚΙΛΚΙΣ,203,114,0,-36,114,2021-01-26T00:00:00,1368,1368,0,1368
ΚΟΖΑΝΗΣ,303,104,101,8,205,2021-01-26T00:00:00,1727,1727,223,1950
ΚΟΡΙΝΘΙΑΣ,1003,121,46,-6,167,2021-01-26T00:00:00,1076,1076,94,1170
ΚΩ,1206,36,0,-17,36,2021-01-26T00:00:00,474,474,0,474
ΛΑΚΩΝΙΑΣ,1004,127,0,-58,127,2021-01-26T00:00:00,1573,1573,0,1573
ΛΑΡΙΣΑΣ,502,158,189,-184,347,2021-01-26T00:00:00,3764,3764,838,4602
ΛΑΣΙΘΙΟΥ,1302,203,0,-7,203,2021-01-26T00:00:00,2119,2119,0,2119
ΛΕΣΒΟΥ,1102,114,0,-42,114,2021-01-26T00:00:00,1345,1345,0,1345
ΛΕΥΚΑΔΑΣ,605,42,0,-30,42,2021-01-26T00:00:00,537,537,0,537
ΛΗΜΝΟΥ,1103,24,0,-18,24,2021-01-26T00:00:00,431,431,0,431
ΜΑΓΝΗΣΙΑΣ,503,233,0,16,233,2021-01-26T00:00:00,1658,1658,0,1658
ΜΕΣΣΗΝΙΑΣ,1005,254,0,-109,254,2021-01-26T00:00:00,2250,2250,0,2250
ΜΗΛΟΥ,1207,0,0,0,0,2021-01-26T00:00:00,0,0,0,0
ΜΥΚΟΝΟΥ,1208,0,0,0,0,2021-01-26T00:00:00,0,0,0,0
ΝΑΞΟΥ,1209,24,0,0,24,2021-01-26T00:00:00,228,228,0,228
ΝΗΣΩΝ,906,0,0,-12,0,2021-01-26T00:00:00,130,130,0,130
ΝΟΤΙΟΥ ΤΟΜΕΑ ΑΘΗΝΩΝ,907,335,0,46,335,2021-01-26T00:00:00,3232,3232,0,3232
ΞΑΝΘΗΣ,105,96,0,0,96,2021-01-26T00:00:00,1322,1322,0,1322
ΠΑΡΟΥ,1210,0,0,0,0,2021-01-26T00:00:00,0,0,0,0
ΠΕΙΡΑΙΩΣ,908,647,89,-1,736,2021-01-26T00:00:00,7056,7056,182,7238
ΠΕΛΛΑΣ,204,133,71,-36,204,2021-01-26T00:00:00,1803,1803,165,1968
ΠΙΕΡΙΑΣ,205,120,91,31,211,2021-01-26T00:00:00,1292,1292,185,1477
ΠΡΕΒΕΖΑΣ,404,48,0,-24,48,2021-01-26T00:00:00,783,783,0,783
ΡΕΘΥΜΝΟΥ,1303,130,0,-14,130,2021-01-26T00:00:00,1340,1340,0,1340
ΡΟΔΟΠΗΣ,106,102,0,6,102,2021-01-26T00:00:00,975,975,0,975
ΡΟΔΟΥ,1211,90,0,-144,90,2021-01-26T00:00:00,1233,1233,0,1233
ΣΑΜΟΥ,1104,36,0,-12,36,2021-01-26T00:00:00,521,521,1,522
ΣΕΡΡΩΝ,206,144,0,0,144,2021-01-26T00:00:00,1609,1609,0,1609
ΣΠΟΡΑΔΩΝ,504,0,0,0,0,2021-01-26T00:00:00,0,0,0,0
ΣΥΡΟΥ,1212,36,0,-24,36,2021-01-26T00:00:00,490,490,0,490
ΤΗΝΟΥ,1213,0,0,0,0,2021-01-26T00:00:00,0,0,0,0
ΤΡΙΚΑΛΩΝ,505,118,86,-119,204,2021-01-26T00:00:00,2110,2110,183,2293
ΦΘΙΩΤΙΔΑΣ,804,162,0,-60,162,2021-01-26T00:00:00,2005,2005,0,2005
ΦΛΩΡΙΝΑΣ,304,86,0,-10,86,2021-01-26T00:00:00,862,862,0,862
ΦΩΚΙΔΑΣ,805,54,0,0,54,2021-01-26T00:00:00,504,504,0,504
ΧΑΛΚΙΔΙΚΗΣ,207,96,0,-28,96,2021-01-26T00:00:00,991,991,2,993
ΧΑΝΙΩΝ,1304,212,155,-9,367,2021-01-26T00:00:00,3020,3020,249,3269
ΧΙΟΥ,1105,48,0,0,48,2021-01-26T00:00:00,635,635,0,635
ΑΙΤΩΛΟΑΚΑΡΝΑΝΙΑΣ,701,145,51,-22,196,2021-01-27T00:00:00,1780,1780,145,1925
ΑΝΑΤΟΛΙΚΗΣ ΑΤΤΙΚΗΣ,901,404,62,-2,466,2021-01-27T00:00:00,3395,3395,531,3926
ΑΝΔΡΟΥ,1201,0,0,0,0,2021-01-27T00:00:00,0,0,0,0
ΑΡΓΟΛΙΔΑΣ,1001,148,0,22,148,2021-01-27T00:00:00,1569,1569,0,1569
ΑΡΚΑΔΙΑΣ,1002,132,0,8,132,2021-01-27T00:00:00,1620,1620,0,1620
ΑΡΤΑΣ,401,91,47,-6,138,2021-01-27T00:00:00,1643,1643,143,1786
ΑΧΑΪΑΣ,702,345,189,30,534,2021-01-27T00:00:00,5340,5340,1099,6439
ΒΟΙΩΤΙΑΣ,801,155,0,35,155,2021-01-27T00:00:00,1488,1488,0,1488
ΒΟΡΕΙΟΥ ΤΟΜΕΑ ΑΘΗΝΩΝ,902,1079,505,-720,1584,2021-01-27T00:00:00,27710,27710,1639,29349
ΓΡΕΒΕΝΩΝ,301,48,0,-6,48,2021-01-27T00:00:00,617,617,0,617
ΔΡΑΜΑΣ,101,150,0,6,150,2021-01-27T00:00:00,1621,1621,0,1621
ΔΥΤΙΚΗΣ ΑΤΤΙΚΗΣ,903,172,2,42,174,2021-01-27T00:00:00,1758,1758,334,2092
ΔΥΤΙΚΟΥ ΤΟΜΕΑ ΑΘΗΝΩΝ,904,589,149,-36,738,2021-01-27T00:00:00,7527,7527,644,8171
ΕΒΡΟΥ,102,245,0,11,245,2021-01-27T00:00:00,3324,3324,0,3324
ΕΥΒΟΙΑΣ,802,390,0,115,390,2021-01-27T00:00:00,3217,3217,0,3217
ΕΥΡΥΤΑΝΙΑΣ,803,30,0,12,30,2021-01-27T00:00:00,409,409,0,409
ΖΑΚΥΝΘΟΥ,601,61,0,14,61,2021-01-27T00:00:00,825,825,0,825
ΗΛΕΙΑΣ,703,203,0,49,203,2021-01-27T00:00:00,2066,2066,0,2066
ΗΜΑΘΙΑΣ,201,150,48,-14,198,2021-01-27T00:00:00,1962,1962,142,2104
ΗΡΑΚΛΕΙΟΥ,1301,355,117,62,472,2021-01-27T00:00:00,6303,6303,371,6674
ΘΑΣΟΥ,103,0,0,0,0,2021-01-27T00:00:00,0,0,0,0
ΘΕΣΠΡΩΤΙΑΣ,402,102,0,12,102,2021-01-27T00:00:00,1164,1164,0,1164
ΘΕΣΣΑΛΟΝΙΚΗΣ,202,1285,782,54,2067,2021-01-27T00:00:00,22263,22263,2814,25077
ΘΗΡΑΣ,1202,18,0,0,18,2021-01-27T00:00:00,185,185,0,185
ΙΘΑΚΗΣ,602,0,0,0,0,2021-01-27T00:00:00,0,0,0,0
ΙΚΑΡΙΑΣ,1101,12,0,0,12,2021-01-27T00:00:00,201,201,0,201
ΙΩΑΝΝΙΝΩΝ,403,258,173,47,431,2021-01-27T00:00:00,4865,4865,895,5760
ΚΑΒΑΛΑΣ,104,203,2,7,205,2021-01-27T00:00:00,2167,2167,2,2169
ΚΑΛΥΜΝΟΥ,1203,60,0,49,60,2021-01-27T00:00:00,439,439,0,439
ΚΑΡΔΙΤΣΑΣ,501,127,95,54,222,2021-01-27T00:00:00,2010,2010,282,2292
ΚΑΡΠΑΘΟΥ,1204,0,0,-30,0,2021-01-27T00:00:00,147,147,0,147
ΚΑΣΤΟΡΙΑΣ,302,96,0,-10,96,2021-01-27T00:00:00,1005,1005,0,1005
ΚΕΑΣ-ΚΥΘΝΟΥ,1205,0,0,0,0,2021-01-27T00:00:00,0,0,0,0
ΚΕΝΤΡΙΚΟΥ ΤΟΜΕΑ ΑΘΗΝΩΝ,905,1645,1632,238,3277,2021-01-27T00:00:00,31537,31537,5836,37373
ΚΕΡΚΥΡΑΣ,603,132,0,-12,132,2021-01-27T00:00:00,1898,1898,0,1898
ΚΕΦΑΛΛΗΝΙΑΣ,604,90,0,36,90,2021-01-27T00:00:00,1012,1012,0,1012
ΚΙΛΚΙΣ,203,138,0,24,138,2021-01-27T00:00:00,1506,1506,0,1506
ΚΟΖΑΝΗΣ,303,114,90,-1,204,2021-01-27T00:00:00,1841,1841,313,2154
ΚΟΡΙΝΘΙΑΣ,1003,102,48,-17,150,2021-01-27T00:00:00,1178,1178,142,1320
ΚΩ,1206,41,1,6,42,2021-01-27T00:00:00,515,515,1,516
ΛΑΚΩΝΙΑΣ,1004,129,2,4,131,2021-01-27T00:00:00,1702,1702,2,1704
ΛΑΡΙΣΑΣ,502,167,183,3,350,2021-01-27T00:00:00,3931,3931,1021,4952
ΛΑΣΙΘΙΟΥ,1302,258,0,55,258,2021-01-27T00:00:00,2377,2377,0,2377
ΛΕΣΒΟΥ,1102,132,0,18,132,2021-01-27T00:00:00,1477,1477,0,1477
ΛΕΥΚΑΔΑΣ,605,36,0,-6,36,2021-01-27T00:00:00,573,573,0,573
ΛΗΜΝΟΥ,1103,36,0,12,36,2021-01-27T00:00:00,467,467,0,467
ΜΑΓΝΗΣΙΑΣ,503,270,0,37,270,2021-01-27T00:00:00,1928,1928,0,1928
ΜΕΣΣΗΝΙΑΣ,1005,240,0,-14,240,2021-01-27T00:00:00,2490,2490,0,2490
ΜΗΛΟΥ,1207,0,0,0,0,2021-01-27T00:00:00,0,0,0,0
ΜΥΚΟΝΟΥ,1208,0,0,0,0,2021-01-27T00:00:00,0,0,0,0
ΝΑΞΟΥ,1209,30,0,6,30,2021-01-27T00:00:00,258,258,0,258
ΝΗΣΩΝ,906,18,0,18,18,2021-01-27T00:00:00,148,148,0,148
ΝΟΤΙΟΥ ΤΟΜΕΑ ΑΘΗΝΩΝ,907,276,0,-59,276,2021-01-27T00:00:00,3508,3508,0,3508
ΞΑΝΘΗΣ,105,96,0,0,96,2021-01-27T00:00:00,1418,1418,0,1418
ΠΑΡΟΥ,1210,0,0,0,0,2021-01-27T00:00:00,0,0,0,0
ΠΕΙΡΑΙΩΣ,908,612,91,-33,703,2021-01-27T00:00:00,7668,7668,273,7941
ΠΕΛΛΑΣ,204,196,110,102,306,2021-01-27T00:00:00,1999,1999,275,2274
ΠΙΕΡΙΑΣ,205,116,69,-26,185,2021-01-27T00:00:00,1408,1408,254,1662
ΠΡΕΒΕΖΑΣ,404,51,0,3,51,2021-01-27T00:00:00,834,834,0,834
ΡΕΘΥΜΝΟΥ,1303,138,0,8,138,2021-01-27T00:00:00,1478,1478,0,1478
ΡΟΔΟΠΗΣ,106,96,0,-6,96,2021-01-27T00:00:00,1071,1071,0,1071
ΡΟΔΟΥ,1211,244,0,154,244,2021-01-27T00:00:00,1477,1477,0,1477
ΣΑΜΟΥ,1104,41,1,6,42,2021-01-27T00:00:00,562,562,2,564
ΣΕΡΡΩΝ,206,150,0,6,150,2021-01-27T00:00:00,1759,1759,0,1759
ΣΠΟΡΑΔΩΝ,504,0,0,0,0,2021-01-27T00:00:00,0,0,0,0
ΣΥΡΟΥ,1212,42,0,6,42,2021-01-27T00:00:00,532,532,0,532
ΤΗΝΟΥ,1213,0,0,0,0,2021-01-27T00:00:00,0,0,0,0
ΤΡΙΚΑΛΩΝ,505,96,101,-7,197,2021-01-27T00:00:00,2206,2206,284,2490
ΦΘΙΩΤΙΔΑΣ,804,192,0,30,192,2021-01-27T00:00:00,2197,2197,0,2197
ΦΛΩΡΙΝΑΣ,304,96,0,10,96,2021-01-27T00:00:00,958,958,0,958
ΦΩΚΙΔΑΣ,805,54,0,0,54,2021-01-27T00:00:00,558,558,0,558
ΧΑΛΚΙΔΙΚΗΣ,207,144,0,48,144,2021-01-27T00:00:00,1135,1135,2,1137
ΧΑΝΙΩΝ,1304,232,184,49,416,2021-01-27T00:00:00,3252,3252,433,3685
ΧΙΟΥ,1105,48,0,0,48,2021-01-27T00:00:00,683,683,0,683
